Ticker,Training Data Size,Test Data Size,Accuracy,train_true,train_false,coef,intercept
AALI.JK,967,241,0.6224066390041494,426,541,[ 0.01003552 -0.03867178  0.01418833  0.08457303 -0.00236641 -0.24946085],-0.23799672802918623
ABBA.JK,879,219,0.6757990867579908,258,621,[ 0.367018    0.04514861  0.07608465 -0.07065102  0.03460609 -0.12764634],-0.893350391360292
ABDA.JK,744,186,0.9139784946236559,75,669,[ 0.00094131  0.17438244 -0.06362255  0.00757259 -0.01989686  0.0034133 ],-2.2235143542670444
ABMM.JK,966,241,0.5643153526970954,260,706,"[-1.82611027e-02  2.35707546e-05  2.44383789e-02  9.05862462e-03
 -9.87209034e-04 -7.36052308e-01]",-0.9978874600265695
ACES.JK,966,241,0.6058091286307054,427,539,[-0.22068429  0.00671447  0.01442117 -0.00653182  0.04036597  0.84668093],-0.23972705487295592
ACST.JK,966,241,0.5892116182572614,337,629,[ 0.3692038   0.01791961  0.00677238 -0.06044094 -0.00496227 -0.17160317],-0.6220839291540916
ADCP.JK,212,52,0.8076923076923077,60,152,[-0.04225435  0.16602591 -0.15954864 -0.02223522 -0.07106616 -1.04353855],-0.9160393265054243
ADES.JK,965,241,0.5601659751037344,384,581,[ 0.0010728   0.04085995 -0.01627915 -0.06861814  0.00142685 -0.61513316],-0.4182310265103641
ADHI.JK,966,241,0.6556016597510373,379,587,[ 0.19328211 -0.01019157  0.02434688 -0.05846409  0.0396674   0.7545385 ],-0.4498197814831217
ADMF.JK,966,241,0.5933609958506224,387,579,[-0.00290198 -0.00472923 -0.01237623  0.01247503  0.00675944 -0.08816899],-0.4047113723870858
ADMG.JK,967,241,0.7219917012448133,356,611,[-0.03129989 -0.01047971 -0.01168738  0.00789854 -0.02267423 -0.41007866],-0.53593060846133
ADMR.JK,240,60,0.75,105,135,[ 0.01603618  0.01674872  0.0154903   0.05105219 -0.00485363  0.01490522],-0.23527415945756544
ADRO.JK,966,241,0.5062240663900415,411,555,[-0.12026838 -0.02684828  0.01365013  0.06240106 -0.05969416 -0.18154081],-0.30433461383575827
AGAR.JK,647,161,0.6273291925465838,184,463,[-0.27510395 -0.0199846   0.0168152   0.06405483  0.02053061 -2.06776474],-0.9110488767534795
AGII.JK,966,241,0.5601659751037344,374,592,[ 0.18026316  0.00334863 -0.00384213 -0.00402204 -0.04081815 -0.62895551],-0.45166879723419995
AGRO.JK,966,241,0.6224066390041494,367,599,"[-1.62567861e-07 -3.98058890e-05  1.04353787e-04 -1.29810244e-05
  2.42553634e-05  2.08396807e-06]",-0.0002455685747229893
AGRS.JK,966,241,0.6887966804979253,330,636,"[-1.49539441e-01 -5.74146880e-02  1.29488851e-01  3.01966735e-02
 -1.01175695e-03 -1.14256809e+00]",-0.6539299785881293
AHAP.JK,965,241,0.6887966804979253,283,682,"[-1.05240628e-01 -1.14290539e-02 -1.28501380e-02  3.98816443e-02
  8.65329162e-04 -1.74110875e+00]",-0.8810320427492806
AIMS.JK,622,155,0.6451612903225806,195,427,[0. 0. 0. 0. 0. 0.],0.0
AISA.JK,547,136,0.6102941176470589,189,358,[ 0.18006324  0.00752773  0.07025367  0.0084851  -0.02493394 -0.78503176],-0.6408481037940597
AKKU.JK,60,14,1.0,4,56,[-0.00680121  0.50778352  0.06139409  0.06276736  0.10888163 -0.15123809],-2.598260835990444
AKPI.JK,964,241,0.6514522821576764,256,708,[-0.19647354 -0.00230814  0.02292145 -0.0084433   0.00593727 -0.38408528],-1.0158713717816459
AKRA.JK,967,241,0.5518672199170125,407,560,[ 0.00531765 -0.01086228 -0.04548562  0.07171726 -0.02740622  0.3215945 ],-0.3314828796679813
AKSI.JK,966,241,0.7012448132780082,318,648,[ 0.01057408 -0.02320987 -0.00743937 -0.20584518  0.01109961  0.43827418],-0.7230441648960266
ALDO.JK,932,233,0.648068669527897,281,651,"[ 2.24979812e-03 -1.42154342e-05 -2.31680999e-02  1.66707632e-02
 -1.19545173e-02 -6.95713071e-01]",-0.8568840412748656
ALKA.JK,966,241,0.6514522821576764,297,669,[-0.47887116 -0.00495335 -0.00109902 -0.00301647 -0.00806047 -0.92573705],-0.8110831467368945
ALMI.JK,966,241,0.6016597510373444,324,642,"[-2.95818336e-01 -3.57569094e-02  1.18263790e-04  1.11089613e-01
  1.02807910e-02 -2.06468598e+00]",-0.6934625647510693
ALTO.JK,906,226,0.7920353982300885,180,726,"[-6.19309845e-02 -2.74624435e-02  4.91569676e-03  2.53811929e-02
  3.36072595e-04 -1.82559289e+00]",-1.4017580110282506
AMAG.JK,962,240,0.6291666666666667,256,706,[-0.18585178  0.02980416 -0.03216383  0.02930789 -0.00645123 -0.43093384],-1.0199528561037101
AMAN.JK,591,147,0.782312925170068,167,424,[ 0.25898462  0.00485745  0.00638765 -0.04822059 -0.00218731  0.26679617],-0.936562043178466
AMAR.JK,628,156,0.5576923076923077,229,399,[-0.19525984  0.07329247 -0.02337246  0.13229153 -0.00657497 -0.3386378 ],-0.5557299996455762
AMFG.JK,960,239,0.5941422594142259,258,702,[ 0.15431527 -0.03009987  0.01218593 -0.00446614  0.00719542 -0.17679079],-1.001033582605392
AMIN.JK,964,240,0.6583333333333333,265,699,[-0.37725292 -0.02555446 -0.01080876 -0.05158138 -0.01015502 -0.89657276],-0.9745129635878659
AMMS.JK,128,32,0.6875,31,97,[-0.04030074 -0.21920763 -0.04373309 -0.70217374  0.12926328  0.98324884],-1.2684468784923275
AMOR.JK,446,111,0.6486486486486487,172,274,[-0.04491602  0.01819707  0.00522531 -0.01419805  0.05105808  0.0315356 ],-0.4696493648571852
AMRT.JK,966,241,0.5020746887966805,346,620,[-0.01047501 -0.07257409  0.0017689   0.03553833  0.00405274 -1.2242344 ],-0.5786762683915975
ANDI.JK,373,93,0.8924731182795699,96,277,[ 0.08705215 -0.00517359  0.13476461  0.01222769  0.08699676  0.09660447],-1.0532393328586418
ANJT.JK,966,241,0.6390041493775933,276,690,"[-2.10028717e-05  2.99826153e-02  5.85011549e-05  2.50123041e-02
  2.29048107e-02  1.01449005e-01]",-0.9203730155085035
ANTM.JK,966,241,0.6016597510373444,408,558,"[-3.91643946e-06 -1.48866042e-03  2.89219755e-03 -1.11964793e-03
  3.83987006e-03 -5.59557599e-05]",-0.0033195536220221745
APEX.JK,908,226,0.6858407079646017,269,639,[-0.41195891 -0.0117734  -0.00275375  0.09755282  0.00212618 -0.33051374],-0.8727895546918308
APIC.JK,924,230,0.5956521739130435,338,586,[-0.00179099  0.03290878 -0.01141102  0.00912285 -0.06217904 -0.20257158],-0.5554554779700964
APII.JK,966,241,0.6390041493775933,302,664,"[-3.53973304e-01  6.97915690e-03 -1.27637262e-02 -6.20618518e-02
 -6.65946441e-04 -1.92587541e+00]",-0.7873816241571485
APLI.JK,966,241,0.6556016597510373,314,652,"[-4.79407397e-02 -9.07261637e-02 -1.51224149e-02  4.01858614e-02
 -7.02180110e-04 -2.52963529e+00]",-0.730581697681771
APLN.JK,966,241,0.5850622406639004,341,625,[ 0.00579571 -0.0513962  -0.01433098  0.02003266 -0.02451629  0.16000431],-0.6096390177886705
ARCI.JK,344,86,0.5930232558139535,124,220,[ 0.00587955 -0.02404748  0.16375108  0.02996055 -0.00673475  0.51616395],-0.5665242848726593
ARGO.JK,560,140,0.7214285714285714,172,388,[-0.41398863  0.03205705 -0.01052617  0.21207466 -0.01329102 -1.36294986],-0.8222967574591663
ARII.JK,954,238,0.6890756302521008,212,742,[-0.19065624  0.00104979 -0.02259222  0.14675829 -0.00562595  0.22870108],-1.2687395027535218
ARKA.JK,444,110,0.8545454545454545,84,360,[ 0.33987941 -0.04540135  0.32402228 -0.38382166 -0.04512616 -0.69067192],-1.5024612502180754
ARKO.JK,144,35,0.4857142857142857,52,92,[-0.00641384 -0.20082509  0.27126586  0.0949971   0.34948056  0.0132116 ],-0.6368972420113548
ARMY.JK,308,77,0.8051948051948052,94,214,[-0.04631149  0.0385815   0.16174005 -0.37095489  0.00920195 -0.13798355],-0.8312565641234109
ARNA.JK,966,241,0.6390041493775933,344,622,[-0.01075164 -0.03311232  0.00759347  0.06709708 -0.00457125 -0.0414075 ],-0.5891303530147357
ARTA.JK,964,241,0.6514522821576764,274,690,[ 0.14526379  0.0423515  -0.00148697 -0.01292189 -0.01816288 -1.18957192],-0.9311533806833889
ARTO.JK,966,241,0.6390041493775933,382,584,[-0.02348083  0.00735505 -0.00200089 -0.00676335 -0.00729752 -0.35829969],-0.4299662134681713
ASBI.JK,967,241,0.5394190871369294,222,745,[-0.23220338 -0.01683011 -0.04749    -0.00337327  0.00161492 -0.69446198],-1.2117084252442711
ASDM.JK,966,241,0.6639004149377593,203,763,[-0.09141439 -0.04974806 -0.06173408 -0.06495754 -0.00249147 -1.73558662],-1.3394158032170997
ASGR.JK,966,241,0.6514522821576764,345,621,"[-4.28970107e-03 -4.59921711e-03 -4.04710202e-03  2.31816587e-02
 -3.57300737e-04 -1.14984949e+00]",-0.5797731183513561
ASHA.JK,167,41,0.6097560975609756,57,110,[ 0.03831005 -0.0778518   0.12060552  0.19034686  0.08758623  0.69453825],-0.6446117095941495
ASII.JK,966,241,0.5892116182572614,411,555,[-0.01240074  0.00635472 -0.01759656  0.01882476  0.00653729 -1.07877899],-0.29602197449856144
ASJT.JK,966,241,0.6639004149377593,328,638,"[-7.45329078e-02  8.91681464e-02 -2.00045010e-03  9.74114670e-02
  2.26554545e-03 -2.07601821e+00]",-0.6670592202300515
ASLC.JK,228,56,0.5535714285714286,79,149,[-0.04868776  0.04772063 -0.00942292  0.09222352 -0.01512025  0.11510907],-0.6392408804120986
ASMI.JK,966,241,0.6721991701244814,286,680,[ 0.21435709  0.02485058 -0.06725807  0.04055359 -0.04668717  0.94933943],-0.8844437618903922
ASPI.JK,592,147,0.6462585034013606,182,410,[-0.01211615 -0.01504774 -0.02259188 -0.50566162  0.00122327 -0.28954324],-0.8247256551613411
ASRI.JK,965,241,0.5933609958506224,368,597,[-0.02745106 -0.00111628 -0.06212738  0.06488735 -0.00711114 -0.64965065],-0.48113937542060986
ASRM.JK,935,233,0.7339055793991416,178,757,"[-2.54879747e-01  5.19857133e-02 -2.67271824e-03  3.54510976e-02
  7.26356607e-03 -3.20903538e+00]",-1.4994653993086524
ASSA.JK,966,241,0.5850622406639004,375,591,[ 0.08551667  0.03920465 -0.0253711  -0.01928116 -0.01262625 -1.05906751],-0.45124756860465576
ATAP.JK,448,111,0.7747747747747747,139,309,[-0.0468266  -0.01567759  0.33538235  0.08148981  0.06938873 -1.3108933 ],-0.8069393321788128
ATIC.JK,967,241,0.6099585062240664,261,706,[-0.35938482  0.00277001  0.00244095 -0.03739049 -0.01327507 -1.07973607],-0.993444698455738
AUTO.JK,966,241,0.5726141078838174,397,569,[-0.00854201 -0.00524661  0.00435773 -0.03082865 -0.00822221  0.21002701],-0.363478286087797
AVIA.JK,254,63,0.5873015873015873,98,156,[-0.01607648  0.11331232 -0.01896931  0.13556995  0.0099811  -0.28843668],-0.5001222283584463
AXIO.JK,136,34,0.6764705882352942,44,92,[-0.01802011  0.15431185 -0.14723924  0.45101221  0.04438879  0.18624528],-0.7235002315277831
AYLS.JK,489,122,0.6885245901639344,147,342,[-0.05130481 -0.10501797  0.0669539   0.10450362 -0.00378336  0.6265601 ],-0.8454056419326248
BABP.JK,649,162,0.6604938271604939,154,495,[ 0.33277839 -0.04978582  0.10284388  0.02832446  0.00730502 -0.16166404],-1.179244680625448
BACA.JK,965,241,0.7178423236514523,245,720,"[-1.98657077e-01  2.31136501e-03  3.22200081e-02 -5.47245966e-06
 -9.30254311e-04  1.05590686e-01]",-1.0801077840406694
BAJA.JK,966,241,0.6556016597510373,311,655,[-0.00104795 -0.02430022  0.02153908 -0.03430976 -0.01650845  0.13106213],-0.7542461512375864
BALI.JK,966,241,0.5975103734439834,335,631,[-0.08054259 -0.02254205  0.08865283 -0.00436538  0.00026226 -0.16051544],-0.639250901483411
BANK.JK,422,105,0.5619047619047619,179,243,[-0.18977045 -0.1103838  -0.06900272  0.03648959 -0.03706824 -0.02701131],-0.306598504152457
BAPA.JK,764,190,0.6842105263157895,214,550,[-0.09395296 -0.00501359  0.00391999 -0.07080531  0.00374247 -1.52094604],-0.9470949469351106
BATA.JK,964,241,0.6887966804979253,267,697,[-0.03495217  0.01002725 -0.00334805 -0.09387532  0.01035845 -2.80393398],-0.9744137026633081
BAUT.JK,108,26,1.0,16,92,[-0.02420333  0.74525389  0.32211119 -0.06667013 -0.45618132 -0.30759608],-1.8785852071974567
BAYU.JK,966,241,0.7676348547717843,244,722,[-0.0333448   0.0144815  -0.012414    0.11244881  0.00056748 -0.340442  ],-1.0875379497384785
BBCA.JK,967,241,0.5311203319502075,437,530,[-0.10238808  0.02832012 -0.01796457  0.00671337  0.00820035 -1.453136  ],-0.19106632165123869
BBHI.JK,965,241,0.6680497925311203,355,610,[-0.09378432 -0.01052805  0.00328786 -0.05394084  0.00180175 -0.42639037],-0.5364034331754937
BBKP.JK,966,241,0.7095435684647303,323,643,[ 0.00485315  0.02991473  0.06938988  0.03849163 -0.03018734 -0.44934965],-0.7005407122397243
BBLD.JK,966,241,0.6058091286307054,178,788,"[-1.99448075e-02  1.98464027e-02  3.74474935e-02  9.67297801e-03
 -4.75084666e-04 -1.55579662e+00]",-1.4923233164096847
BBMD.JK,888,221,0.8099547511312217,173,715,[ 0.08535255  0.02542969  0.03202939 -0.02324716  0.0059455   0.0588179 ],-1.4310478633064796
BBNI.JK,966,241,0.5809128630705395,426,540,[ 0.00412052  0.12507437 -0.02266044  0.26487883 -0.00517231  0.34005621],-0.24852371972506754
BBRI.JK,966,241,0.4979253112033195,436,530,"[-3.49518443e-04  1.29260931e-05 -1.66905242e-02  4.11943729e-03
  3.43911736e-03 -9.21951627e-03]",-0.19198925158430558
BBRM.JK,328,81,0.691358024691358,64,264,[-0.23023924  0.00291     0.07084141 -0.00666863 -0.0305054  -0.38509798],-1.4313561242375512
BBSI.JK,500,124,0.5645161290322581,210,290,[ 0.03287925  0.01484459 -0.23582665  0.01916571 -0.00213097 -0.49342305],-0.3257891364060358
BBSS.JK,557,139,0.6690647482014388,154,403,[-0.05280491  0.03901077  0.06751115  0.10711673  0.0068822  -1.3861535 ],-0.9723628924949792
BBTN.JK,966,241,0.5975103734439834,398,568,[ 0.00457308 -0.01029141  0.00042443  0.00441604  0.00281266 -0.08555832],-0.35656905250200527
BBYB.JK,966,241,0.6265560165975104,329,637,"[ 2.00327635e-02 -3.81614358e-02  9.49762121e-05  9.66662400e-03
 -1.66741532e-02 -7.79535143e-01]",-0.6636815963547903
BCAP.JK,933,233,0.6995708154506438,271,662,[ 0.39924655  0.01340917 -0.11421072  0.17839016 -0.0522773   0.37918734],-0.9024077099743454
BCIC.JK,377,94,0.648936170212766,103,274,[ 0.59345815  0.23203863 -0.13366245 -0.15845525 -0.02338289  0.9897982 ],-0.9834434823552838
BCIP.JK,887,221,0.6515837104072398,222,665,[-0.10923824 -0.04533611  0.13138256 -0.04924425  0.00881403 -0.45523788],-1.1058017305193535
BDKR.JK,9,2,0.0,5,4,[ 0.00125894  0.45490429  0.09386638  0.03203913 -0.40826457  0.06796938],0.03437246438306587
BDMN.JK,966,241,0.6224066390041494,379,587,[ 0.28660743 -0.01905443  0.00219946  0.00546818 -0.01121232  0.31973833],-0.43915681112887006
BEBS.JK,366,91,0.7802197802197802,168,198,[0.30263647 0.05518088 0.02932568 0.00862612 0.01380518 0.85667999],-0.16211370224013508
BEEF.JK,832,207,0.6859903381642513,262,570,"[-1.63640058e-02 -4.48239688e-04  1.33543477e-01 -8.27265956e-03
 -6.75445892e-03 -9.17377803e-01]",-0.7799743359246241
BEER.JK,40,10,0.8,15,25,[-0.00687143 -0.06727044 -0.72475262 -0.98641189  0.29399963 -0.05720454],-0.6068860378307811
BEKS.JK,256,64,0.96875,69,187,[-0.09795997  0.01563739  0.0390766   0.0287655   0.00601508 -0.54225737],-1.003479688062679
BELI.JK,75,18,0.6666666666666666,21,54,[-0.00122106  0.52296563 -0.15198783 -0.05267619  0.23869428 -0.56857021],-1.0662177884003332
BELL.JK,966,241,0.6431535269709544,290,676,"[ 9.80093735e-02 -9.59969820e-06  2.05539791e-02  8.53922738e-02
  3.04976037e-03 -1.42805081e+00]",-0.8549442257565578
BESS.JK,594,148,0.5945945945945946,250,344,[ 0.29636687  0.0272658  -0.02073921  0.04079568 -0.01751257  1.51496758],-0.3312953293103878
BEST.JK,966,241,0.6141078838174274,335,631,[ 0.07289528 -0.02417756  0.08441301  0.0455992  -0.0159528  -0.01561814],-0.6355336096825299
BFIN.JK,966,241,0.5394190871369294,349,617,"[ 4.85945296e-05  2.78323632e-02 -1.11478729e-02 -7.07924022e-03
  9.11313628e-02 -7.61031825e-01]",-0.5729999398750095
BGTG.JK,933,233,0.6909871244635193,273,660,[-0.00160922 -0.01828168 -0.02764936  0.02312253 -0.00614421 -0.86959418],-0.880265862936808
BHAT.JK,571,142,0.6056338028169014,243,328,[ 0.00955248  0.04382578  0.01026748  0.10214583 -0.00154521 -0.74719159],-0.2919912337795658
BHIT.JK,888,222,0.7387387387387387,250,638,[-0.06860704  0.00632687 -0.00667081  0.12521673  0.01172095 -0.8823227 ],-0.9404581188078178
BIKA.JK,964,241,0.6597510373443983,309,655,[-0.58806565  0.00910535  0.01611861 -0.00681597  0.00209839 -1.55156413],-0.7425667399116469
BIKE.JK,199,49,0.7346938775510204,74,125,[ 0.03225989 -0.22317367  0.01311222 -0.01054272 -0.09688347 -0.02038555],-0.5115380980075125
BIMA.JK,700,174,0.6724137931034483,181,519,"[-7.02452812e-02 -6.10448110e-02  1.99833725e-02  6.45648966e-03
  2.82076795e-04 -1.02644089e+00]",-1.0504740667819215
BINA.JK,966,241,0.6680497925311203,388,578,[-0.00770184 -0.05448402 -0.00166126 -0.05265946  0.0134335   0.04685661],-0.4043271768907822
BINO.JK,260,65,0.7692307692307693,95,165,[ 0.00074971  0.08480738  0.06801798 -0.21157552 -0.02249962 -0.57169871],-0.5585591117821612
BIPI.JK,508,126,0.5793650793650794,107,401,"[ 2.10023600e-01 -2.08938477e-02  2.64449966e-02 -3.90114530e-04
 -1.08037159e-02 -1.11489301e+00]",-1.3270333889176265
BIPP.JK,859,214,0.7897196261682243,203,656,[-0.1439537   0.01334488 -0.03296298 -0.00743079 -0.00627974 -2.22014525],-1.1838590842140582
BIRD.JK,966,241,0.5684647302904564,357,609,[ 0.06198386  0.00229668 -0.01506927  0.00241881  0.02153377  0.79598687],-0.5378976647898203
BISI.JK,966,241,0.6141078838174274,338,628,[ 0.10414402  0.00169826 -0.01769445  0.02317827  0.01092959  0.04070904],-0.6243952876013175
BJBR.JK,966,241,0.6348547717842323,414,552,[ 0.00056057 -0.02194938 -0.01738215 -0.00174969 -0.01272864  0.1860069 ],-0.29109740925279715
BJTM.JK,966,241,0.7427385892116183,349,617,[-0.03436166 -0.00592915 -0.0243347   0.00295494  0.00113465 -1.12404893],-0.5632392014496036
BKDP.JK,950,237,0.70042194092827,217,733,[-0.16917317  0.05205534 -0.00660441 -0.01913261 -0.01670006 -2.23128851],-1.2265496062789216
BKSL.JK,813,203,0.8325123152709359,234,579,[-0.07505459 -0.02903883  0.01397951  0.12983714 -0.00826237 -1.25350845],-0.9128585551220522
BKSW.JK,966,241,0.6473029045643154,298,668,[-0.3849793  -0.004851    0.04120114  0.02292482  0.00433174 -0.28762202],-0.8122163388960598
BLTZ.JK,838,209,0.7129186602870813,151,687,[-0.06148779  0.04131968 -0.01616006  0.06189661  0.03019291 -0.00110386],-1.522673359376496
BLUE.JK,731,182,0.6813186813186813,289,442,"[-4.05247640e-04 -2.95021953e-05 -3.64688430e-02  3.49118571e-03
  1.21942138e-02 -1.06305017e+00]",-0.41431308986198584
BMAS.JK,966,241,0.5933609958506224,288,678,[-0.18155353 -0.01174278 -0.0403126  -0.01170033  0.00038192  0.17005777],-0.8626839986725563
BMBL.JK,38,9,0.7777777777777778,12,26,[-0.01162908 -0.00351791  0.0292349   0.1709535  -0.28154034  0.84500606],-0.8384977814347535
BMHS.JK,340,84,0.6904761904761905,111,229,[-0.05540707  0.069862    0.0400713  -0.02610795  0.01538746 -0.1007064 ],-0.7328264498088036
BMRI.JK,967,241,0.5145228215767634,438,529,[-0.02632398  0.00161154  0.1580526  -0.01745641 -0.01006318 -0.14240455],-0.19440542057175314
BMSR.JK,966,241,0.6721991701244814,336,630,[-0.43573696 -0.00227197 -0.00113535 -0.00584845  0.0138197  -0.83130453],-0.6208501812852713
BMTR.JK,965,241,0.6099585062240664,357,608,[-0.08370215 -0.01522063 -0.00524987 -0.01223497  0.01405647  0.04312263],-0.5373517252888881
BNBA.JK,966,241,0.6473029045643154,362,604,[ 0.12512645 -0.01877818 -0.03210004  0.00460496 -0.03658785 -0.58507652],-0.5122410114454998
BNBR.JK,268,66,0.6363636363636364,57,211,[ 0.11466972 -0.13472389 -0.08211287 -0.06969299  0.01368252 -0.02721729],-1.3799563277576845
BNGA.JK,966,241,0.6265560165975104,365,601,[-0.12887673 -0.02345644  0.00482091 -0.05836642  0.01815473  0.38997762],-0.5023564584746324
BNII.JK,966,241,0.7136929460580913,330,636,"[-1.32943717e-01  7.56407442e-03 -2.64620084e-02  1.16886525e-02
 -4.65143794e-04 -1.12258528e+00]",-0.6524832967855007
BNLI.JK,966,241,0.6639004149377593,369,597,[ 0.04946541 -0.02881267 -0.01096597  0.0076491   0.00646126  0.30139627],-0.4868585282238359
BOBA.JK,276,68,0.6617647058823529,90,186,[-0.04962584  0.0516698  -0.06838044 -0.1724033   0.03625601 -0.83102149],-0.7276551487431926
BOGA.JK,966,241,0.6348547717842323,354,612,[-0.0120752   0.01303234 -0.01139771 -0.04591564 -0.01778658  1.18415131],-0.5661914839555777
BOLA.JK,742,185,0.6648648648648648,278,464,[-0.01385157  0.0298592  -0.02160233  0.06408281  0.02136    -1.26236537],-0.5105032168629988
BOLT.JK,964,240,0.6875,268,696,[-0.32598454  0.01867318  0.00549216  0.00322094 -0.00218486 -0.56141614],-0.9562593991772814
BOSS.JK,966,241,0.6639004149377593,326,640,[ 0.0074231  -0.00907757  0.00226578  0.04827218 -0.00093224  0.22734113],-0.6767957992080191
BPFI.JK,812,202,0.698019801980198,108,704,[ 0.12941213 -0.02256424  0.11169206  0.0357894   0.03421181 -0.13291709],-1.8849829698409788
BPII.JK,510,127,0.8976377952755905,39,471,[0. 0. 0. 0. 0. 0.],0.0
BPTR.JK,937,234,0.6581196581196581,313,624,"[-4.85231471e-02  1.79009127e-02  4.51368087e-02  2.21244070e-02
 -1.32436936e-03 -2.11091560e+00]",-0.6902143463027249
BRAM.JK,938,234,0.688034188034188,166,772,"[ 1.56391962e-01 -2.93978136e-03 -1.29453728e-02  1.67478636e-04
  8.05701215e-03  2.02114840e-01]",-1.5433755060672052
BRIS.JK,966,241,0.6016597510373444,342,624,[ 0.2362341   0.01963831 -0.0121264  -0.00888463  0.02619882 -0.08622633],-0.5927406001699108
BRMS.JK,788,196,0.6275510204081632,229,559,"[ 2.92974734e-03  4.16750826e-02  6.65185716e-03  8.54674974e-03
  7.70056908e-04 -8.44852446e-01]",-0.8902205860513476
BRNA.JK,964,240,0.8541666666666666,190,774,[-0.18767878 -0.00815322  0.0313585  -0.00336503  0.0009854  -0.58864434],-1.4049261256551862
BRPT.JK,967,241,0.5892116182572614,417,550,"[ 1.40870370e-02 -6.21376678e-06 -3.19642710e-02  1.50579855e-01
  3.23576509e-03 -6.27084795e-01]",-0.27499242330726414
BSBK.JK,66,16,1.0,12,54,[-0.03863331  0.21744037  0.3354727   1.03029519 -0.26233376  0.22611234],-1.5359346953352597
BSDE.JK,965,241,0.5892116182572614,393,572,[-0.01243746 -0.0015093   0.01075545 -0.00281009  0.00403185 -0.6729192 ],-0.37648819514006576
BSIM.JK,964,241,0.6804979253112033,308,656,[-0.27728163 -0.03448596 -0.03569767  0.05233286 -0.00176136 -1.46729888],-0.7541396913000749
BSML.JK,249,62,0.7419354838709677,87,162,[-0.01846948  0.00439531 -0.06938413 -0.00039259  0.00320612  0.36818951],-0.62377680155252
BSSR.JK,966,241,0.5228215767634855,349,617,[-0.00464055  0.01679763  0.03980577  0.0043617   0.01448233 -1.02987365],-0.56148467837328
BTEK.JK,305,76,0.7368421052631579,117,188,[-0.14680593  0.0463786  -0.01040479  0.01430938  0.15114311 -1.40604939],-0.46202935430840064
BTON.JK,966,241,0.6141078838174274,352,614,"[-9.92678435e-02  3.74113293e-03  1.45573419e-02 -4.48729106e-03
 -8.84910786e-04 -3.44047271e+00]",-0.5576796018430871
BTPN.JK,966,241,0.6265560165975104,386,580,"[-1.90960183e-02  2.52046407e-02 -7.90870720e-03 -7.63300965e-04
 -1.42307670e-03 -8.59498743e-01]",-0.4050305636889458
BTPS.JK,966,241,0.6224066390041494,434,532,[ 0.0040601  -0.01494283 -0.00329311  0.07458814  0.00125453  0.30626392],-0.207168646926411
BUAH.JK,126,31,0.1935483870967742,57,69,[ 0.02748028  0.02049501  0.12417136  0.19009982 -0.04529908  0.18555155],-0.19136825215457634
BUDI.JK,966,241,0.6639004149377593,322,644,"[-2.51870275e-02 -1.05142696e-05 -2.13110040e-02  7.01630166e-03
 -3.26796595e-03 -1.35856725e+00]",-0.6940778365698674
BUKA.JK,322,80,0.6625,125,197,[ 0.00536027 -0.02106178  0.25173127  0.06155173 -0.01235569 -0.21041762],-0.46247722254726453
BUKK.JK,965,241,0.6307053941908713,356,609,[-0.25589555 -0.06905056  0.00448118  0.23597498 -0.00672226 -1.59619567],-0.5287889689052825
BULL.JK,967,241,0.5933609958506224,385,582,[-0.00504824  0.01593773 -0.0005734  -0.00501647 -0.00060032 -0.18969087],-0.41027220575261575
BUMI.JK,884,220,0.5636363636363636,266,618,[0.01578047 0.00477854 0.04102114 0.03238801 0.01639076 0.17918812],-0.8487139553458913
BUVA.JK,623,155,0.7354838709677419,204,419,[-0.05295092 -0.02634849 -0.01085823 -0.04556557 -0.01114586 -0.97834039],-0.7191843630907085
BVIC.JK,965,241,0.6514522821576764,332,633,[-0.28229284 -0.02645589  0.01080178 -0.00652455  0.07050247 -0.70340495],-0.6333126332059121
BWPT.JK,966,241,0.7302904564315352,344,622,[-0.09494949 -0.02057525 -0.0155185   0.01800964  0.00055598  0.05710087],-0.5911900709604225
BYAN.JK,936,234,0.49145299145299143,284,652,"[ 1.43607900e-03 -4.60685459e-05 -1.71510400e-04 -2.16639084e-02
  5.87614727e-03 -1.27241821e-01]",-0.8324088959681066
CAKK.JK,804,201,0.6467661691542289,237,567,[ 0.16198715 -0.02434663 -0.03577848  0.13014349 -0.00305328 -1.44386554],-0.8776797708535177
CAMP.JK,966,241,0.6016597510373444,354,612,[ 0.00683762  0.00537264 -0.00258584 -0.03972409 -0.00092862 -0.60331643],-0.543248819316291
CANI.JK,963,240,0.6458333333333334,252,711,[-0.43828651  0.08455183 -0.00065377  0.01034988  0.02260589  0.2125569 ],-1.0422479284931698
CARE.JK,589,147,0.5918367346938775,220,369,[-0.01407047  0.01111485 -0.08331049  0.00421478  0.10899767  0.34880672],-0.5262604262789303
CARS.JK,541,135,0.6370370370370371,177,364,"[ 2.92809121e-05  4.43615103e-05 -6.03882971e-04  3.91499258e-03
  6.14427562e-03 -9.22466786e-05]",-0.006147083457720357
CASA.JK,964,240,0.675,276,688,[-0.00344149 -0.02772347  0.00261724 -0.01865085  0.03161921 -0.46473555],-0.9051817045453104
CASH.JK,564,141,0.6524822695035462,204,360,[ 0.01005806  0.11216367 -0.28654531  0.07677835  0.03174303  0.52124546],-0.5744285487063928
CASS.JK,965,241,0.5643153526970954,255,710,[-0.01969427 -0.01868945  0.04949472  0.04367285 -0.00281685 -1.12289498],-1.0230980240493928
CBMF.JK,472,118,0.864406779661017,150,322,[ 0.52251162  0.00940314  0.00347594  0.05102152 -0.02226618  0.19342018],-0.7793426266625468
CBPE.JK,40,10,0.8,16,24,[-0.00869613 -0.17878042  0.1100335   0.80521402  0.01059298 -0.2830242 ],-0.402953578230416
CBRE.JK,40,9,1.0,9,31,[ 0.00417878  0.1980071   0.05305942 -0.035543   -0.41023976 -0.22156627],-1.2589825291871026
CBUT.JK,75,18,0.4444444444444444,36,39,[-0.02397396  0.2619114   0.16790038 -0.51999821 -0.55904301  0.06499177],-0.07308890692667568
CCSI.JK,742,185,0.7405405405405405,283,459,[-0.01519468  0.01425723  0.08768282 -0.05592492 -0.00755199 -1.41555451],-0.48109074338531843
CEKA.JK,966,241,0.6473029045643154,392,574,[-0.01875559 -0.03449868  0.00661295 -0.04076748  0.00924272 -1.35562199],-0.37177541455085616
CENT.JK,965,241,0.7178423236514523,331,634,[ 0.0791203  -0.07486942 -0.03062603  0.0943629   0.00354967 -1.02598539],-0.6519975424663348
CFIN.JK,965,241,0.6265560165975104,335,630,[-0.09047182  0.02103084 -0.03396651  0.03401437  0.00239108 -1.20781711],-0.6345851625378424
CHEM.JK,144,35,0.6571428571428571,47,97,[-0.09259302 -0.05447011  0.05135886 -0.41942334  0.01955538 -0.36335462],-0.7590019363178973
CHIP.JK,23,5,0.2,9,14,[-0.01039287  0.05078073  0.11354832 -0.07064712  0.27602406  0.24300536],-0.5110445274228453
CINT.JK,966,241,0.7344398340248963,309,657,"[-2.77691080e-01 -8.19091163e-02  4.67631151e-03  1.39192406e-03
  6.52079683e-03 -2.44432369e+00]",-0.7507911253950799
CITA.JK,967,241,0.6763485477178424,282,685,[-0.01085747  0.01106657 -0.00141782  0.0029313  -0.00366132 -0.18371175],-0.8893297550038828
CITY.JK,890,222,0.6846846846846847,291,599,"[-1.26709405e-01 -3.87260678e-04  4.95838256e-02 -4.68622359e-02
 -2.62823241e-03 -1.28915613e+00]",-0.7299527698058791
CLAY.JK,826,206,0.7427184466019418,246,580,[ 0.11284578 -0.05047393 -0.0049929   0.01939784  0.02195999 -1.09147438],-0.851437278464226
CLEO.JK,966,241,0.5975103734439834,337,629,[-0.00042233  0.00652723  0.00578075 -0.00036511  0.01236555 -0.00522584],-0.6202127652201828
CLPI.JK,966,241,0.6763485477178424,343,623,[ 0.0040621  -0.01166048 -0.00800377 -0.00764131  0.00927707 -1.80365432],-0.5977627942580861
CMNP.JK,966,241,0.6514522821576764,380,586,[-0.00750731  0.05002266  0.08962607 -0.0190308   0.00628883 -0.17534287],-0.43052086107253995
CMNT.JK,305,76,0.7105263157894737,114,191,[-0.00849002  0.01412796 -0.15082516 -0.02154605  0.00097856  0.18089159],-0.5319683902659204
CMPP.JK,508,127,0.6850393700787402,151,357,[ 0.01132884 -0.00302205  0.08988272  0.02194927  0.00967925  0.43145497],-0.8653680012042108
CMRY.JK,256,63,0.5079365079365079,119,137,[-0.07543943 -0.01766153  0.00605726 -0.16419111 -0.00303038 -0.13094101],-0.12811641266940665
CNTX.JK,965,241,0.7385892116182573,238,727,"[-4.06692302e-01  3.17567161e-02  2.69152857e-02  6.71957296e-04
  2.70392675e-02 -2.62846942e+00]",-1.1249505287064878
COAL.JK,110,27,0.6296296296296297,32,78,[-0.010708    0.52858649  0.03608141 -0.23721257  0.44025     0.97941345],-0.9180639106120115
COCO.JK,792,198,0.6111111111111112,241,551,[-0.05975887 -0.05427144  0.02373292  0.02157457  0.00072928 -0.32242482],-0.8230808939698087
COWL.JK,308,77,0.8831168831168831,93,215,[-0.07609146  0.23153473  0.03816966  0.08888363 -0.0784884  -0.51115751],-0.8700375083556028
CPIN.JK,966,241,0.5518672199170125,432,534,[-0.01258482  0.00251891 -0.00218569 -0.00255083 -0.00588422 -0.70993467],-0.2137658502140252
CPRI.JK,120,30,0.9666666666666667,24,96,[-0.02617664 -0.29567981  0.756348    0.33452342 -0.11861324 -0.49142951],-1.3849384270911562
CPRO.JK,308,77,0.8181818181818182,88,220,[ 0.10289629 -0.04428581  0.16924736  0.0136896   0.00118606 -0.74288693],-0.9343242217372613
CRAB.JK,124,31,0.7096774193548387,41,83,[-0.02819733  0.25502844 -0.92285438 -0.65101769  0.56587179 -0.99677739],-0.6754673559517765
CSAP.JK,966,241,0.6182572614107884,309,657,[-0.10567376  0.02755716  0.00424426  0.04691106  0.02090028 -1.65186603],-0.7567653866300215
CSIS.JK,914,228,0.7017543859649122,272,642,[ 0.05652537  0.01380631 -0.01871696  0.04315139 -0.00893778 -0.87982577],-0.8612986268967803
CSMI.JK,430,107,0.9252336448598131,122,308,[ 0.22586067  0.02712154  0.51546953  0.00923823 -0.04793911 -0.21177846],-0.9306011772072197
CSRA.JK,627,156,0.6025641025641025,229,398,[-0.06542794 -0.00913896  0.16290069  0.04878813 -0.02900877 -0.0532979 ],-0.5576863554078175
CTBN.JK,609,152,0.6907894736842105,121,488,[-0.34393089  0.0222127   0.01726869 -0.04598792 -0.01620707  0.00098677],-1.4074688536415019
CTRA.JK,966,241,0.6265560165975104,401,565,[ 0.06025866  0.06751335 -0.02884613  0.03772252 -0.00394657 -0.01542846],-0.34262546008448047
CTTH.JK,680,170,0.8647058823529412,185,495,[-0.12473548 -0.03572045  0.16796508 -0.23802284 -0.01232576 -1.87917158],-1.003315705888982
CUAN.JK,7,1,0.0,3,4,[-0.01152186  0.42582909 -0.19451926 -0.02701167  0.10677035 -0.15370971],-0.42555063741536325
DADA.JK,270,67,0.9850746268656716,47,223,[-0.1283085   0.25922133 -0.09372005  0.0658924   0.12510307  0.68284369],-1.590714224700645
DART.JK,966,241,0.6514522821576764,252,714,[-0.3636048  -0.00870912  0.00803089 -0.01107362  0.00409222 -0.97842585],-1.0437473338020407
DAYA.JK,965,241,0.5933609958506224,214,751,[-0.50874727 -0.0257477  -0.01076291 -0.05392416  0.03548457  0.06156231],-1.2611459231668507
DCII.JK,424,106,0.9056603773584906,96,328,[ 0.33655156 -0.02502572 -0.00067744  0.1220611   0.00931129  0.32092225],-1.2414928050645495
DEAL.JK,548,136,0.75,214,334,[ 0.51618813  0.16333139 -0.0086568  -0.24399404  0.0114021   1.16663894],-0.45924770075154364
DEFI.JK,722,180,0.7722222222222223,192,530,"[ 1.56951204e-01 -3.39961293e-02 -2.89630048e-04 -5.35548870e-02
  5.06532595e-04  5.17166434e-01]",-1.0286117124331626
DEPO.JK,261,65,0.7538461538461538,104,157,[-0.0410107   0.02204036  0.01665466  0.00417001  0.00471746 -0.96301396],-0.38823584328491056
DEWA.JK,232,57,0.8421052631578947,71,161,[-0.01026317 -0.07928263 -0.0182775   0.01621459  0.01650384 -0.29353284],-0.8220312373035785
DEWI.JK,139,34,0.47058823529411764,65,74,[-0.08267383 -0.0375689  -0.04329855 -0.03798136 -0.01843411 -0.30682753],-0.12165408945978558
DFAM.JK,964,241,0.7510373443983402,314,650,"[ 1.90983193e-01  5.85452952e-03 -9.40801172e-04  7.32999761e-03
 -6.25322621e-03 -1.41044397e+00]",-0.7239758092236553
DGIK.JK,484,120,0.6833333333333333,168,316,[ 0.11295371  0.07065517  0.02284538  0.0351376   0.04297266 -0.32431855],-0.6199025807697286
DGNS.JK,431,107,0.6822429906542056,163,268,[-0.00840579  0.01667851 -0.1895637  -0.23213987  0.00988235 -0.42574807],-0.5070011951337582
DIGI.JK,752,187,0.732620320855615,182,570,"[-1.29445944e-01 -9.65738245e-04 -5.99820927e-02 -3.31170545e-02
 -3.54525300e-02 -1.44803698e+00]",-1.1584337532270301
DILD.JK,966,241,0.6390041493775933,337,629,[-0.0039076   0.03412819  0.02155497  0.0361287   0.00446134 -0.89355171],-0.6211487164404871
DIVA.JK,857,214,0.5841121495327103,331,526,[ 0.24117327  0.05496421 -0.13769495  0.12142538  0.00660831  0.78734494],-0.46159718675658457
DKFT.JK,966,241,0.6431535269709544,342,624,"[-1.65051373e-01 -1.45097154e-02  7.40448816e-02  5.04949799e-02
  7.47350075e-04 -1.18254864e+00]",-0.5955123385678937
DLTA.JK,966,241,0.6224066390041494,315,651,"[-1.05516698e-03 -2.73900077e-03  3.84279925e-02  1.09210136e-03
  8.26073662e-03 -1.16038709e+00]",-0.7272847460368372
DMAS.JK,965,241,0.6804979253112033,378,587,"[-1.28804957e-02 -2.15342630e-02  2.93709033e-02 -3.89937483e-02
  8.81589495e-04 -1.02583861e+00]",-0.433455544486511
DMMX.JK,671,167,0.6287425149700598,283,388,[ 0.88686693 -0.03837441 -0.2456607   0.0020963  -0.0079946   0.10021696],-0.3318794373246553
DMND.JK,619,154,0.7532467532467533,205,414,[-0.13288585 -0.00592102 -0.03416163  0.26476396  0.0086572  -2.78044165],-0.7060821956328001
DNAR.JK,966,241,0.6556016597510373,295,671,[-0.16227426 -0.00627747 -0.02543617  0.03385706  0.01605768 -0.6034092 ],-0.8288050292563469
DNET.JK,964,240,0.6625,237,727,"[-2.93770212e-02  4.76733300e-02 -1.63801629e-04 -8.02452657e-02
 -1.10862969e-03 -1.56452062e+00]",-1.1172586619886717
DOID.JK,966,241,0.5560165975103735,364,602,[-0.00420247 -0.00274454  0.03392428  0.04766248 -0.0050352  -1.02152107],-0.5012034090902605
DPNS.JK,967,241,0.6058091286307054,261,706,[-0.00427143  0.01358883 -0.01595162 -0.00186846 -0.02110724 -1.36506603],-0.9986648016596762
DPUM.JK,506,126,0.8015873015873016,134,372,[-0.1307453   0.05827497 -0.00564817 -0.01365421  0.04155923  0.09407418],-1.0411924173855567
DRMA.JK,248,61,0.5245901639344263,100,148,"[-5.18596142e-07 -1.96945018e-06 -1.83935901e-04 -1.39604964e-03
 -1.14322400e-03 -1.45238233e-05]",-0.0003721729150027445
DSFI.JK,963,240,0.6916666666666667,314,649,[-0.25431448  0.00377603  0.00548273  0.02581109  0.00293978 -2.18867192],-0.7229247909287964
DSNG.JK,965,241,0.6016597510373444,345,620,[-0.07267217  0.01696509  0.01223776 -0.01220685 -0.00376438 -0.16225968],-0.588419166095894
DSSA.JK,903,225,0.9111111111111111,125,778,[0.09630042 0.01486703 0.06628433 0.01072971 0.00097913 0.00944484],-1.8440661102376006
DUCK.JK,567,141,0.7446808510638298,193,374,[ 0.19639313 -0.03405184  0.10341325  0.04270192  0.00192935  0.68285794],-0.6603705965017858
DUTI.JK,884,221,0.6561085972850679,184,700,[-0.06199783  0.03522743 -0.01576258  0.01273657  0.00274945 -0.05768246],-1.3311929531516147
DVLA.JK,966,241,0.6804979253112033,308,658,"[-5.48393243e-02 -7.25283754e-05  1.56146078e-02  9.69452444e-03
 -7.49402968e-03 -3.12461993e+00]",-0.76775954295538
DWGL.JK,965,241,0.6016597510373444,341,624,"[-1.99553625e-02  9.59375619e-04  5.86369665e-04 -1.07368562e-02
  1.28203562e-03 -1.30506045e+00]",-0.6024575425972404
DYAN.JK,909,227,0.6387665198237885,282,627,[-0.17050943 -0.06542839  0.1115735  -0.03215254 -0.00208806 -1.23510032],-0.7968596701273861
EAST.JK,730,182,0.6373626373626373,242,488,[ 0.04716024 -0.00763451 -0.01203164  0.03108392 -0.05135148 -0.72076202],-0.6980269866653176
ECII.JK,937,234,0.8205128205128205,108,829,[-0.09857554 -0.00096774 -0.00154629 -0.03792788  0.0049776   0.01716109],-2.03914647196071
EDGE.JK,417,104,0.8269230769230769,142,275,[-0.06925065 -0.05978269 -0.12906308  0.05098871  0.01007715 -1.30983471],-0.6719132236053054
EKAD.JK,967,241,0.7136929460580913,373,594,[-0.00816109 -0.00694175 -0.01593756 -0.05998779 -0.03659666 -1.13390761],-0.4573275740189774
ELIT.JK,40,10,0.3,19,21,[-0.01161643 -0.34991627 -0.33396497 -0.01141375 -0.03444411 -0.260742  ],-0.07446863061032626
ELPI.JK,127,31,0.6774193548387096,44,83,[-0.0079887  -0.1228825  -0.31937902 -0.33190595 -0.09330505 -0.83109231],-0.6373242327649316
ELSA.JK,966,241,0.5643153526970954,377,589,[-0.07960846 -0.10256866 -0.0070353  -0.0336355  -0.01403198 -1.06244682],-0.44286519769861443
EMDE.JK,948,236,0.6949152542372882,167,781,[-0.16654961 -0.04754752  0.05042039  0.00520412  0.01328315 -0.05617665],-1.5568421268921333
EMTK.JK,967,241,0.6265560165975104,281,686,[ 0.07845332 -0.02054839 -0.00556291 -0.01672475 -0.00379414 -0.60724894],-0.8842378943959758
ENAK.JK,220,55,0.5818181818181818,95,125,[ 0.044827   -0.03578071 -0.13726224  0.10638168  0.00432718  1.69002366],-0.30281246924970734
ENRG.JK,938,234,0.5854700854700855,291,647,[ 0.04016948 -0.06112128 -0.00876793 -0.01877913  0.00078345 -0.52746753],-0.7973370199658171
ENVY.JK,264,66,0.9242424242424242,84,180,[0.45688521 0.48287626 0.03920305 0.06313019 0.11721552 1.28518902],-0.7625978723117628
ENZO.JK,272,68,0.7794117647058824,67,205,[ 0.01065339  0.01355392  0.07730023  0.10760195 -0.00639585 -0.93915323],-1.1131806034003073
EPAC.JK,312,77,0.8571428571428571,85,227,[ 0.01756908  0.08015136 -0.05680026 -0.11999844 -0.04750716 -0.53427732],-0.9858401625794848
EPMT.JK,966,241,0.5103734439834025,275,691,"[-3.53249790e-12 -9.80323439e-07  1.14088281e-09 -4.49060961e-10
  1.46909833e-09 -3.44056918e-10]",-3.5154125787902027e-09
ERAA.JK,967,241,0.6058091286307054,400,567,[-0.07067878 -0.003879   -0.01099769  0.04512754 -0.01168357 -0.92681995],-0.34257074166210055
ERTX.JK,966,241,0.6265560165975104,310,656,"[-4.78630490e-01  8.70457729e-04  1.40373518e-02  6.39930306e-03
  1.89612486e-02 -1.97839314e+00]",-0.7481283746129558
ESIP.JK,656,164,0.7804878048780488,218,438,[-0.15047518  0.00138137  0.0188588   0.01988228  0.00457978 -0.10900578],-0.6955706431160631
ESSA.JK,966,241,0.5767634854771784,376,590,"[-2.52362684e-02  6.21975409e-04 -4.16633136e-02 -8.98733890e-03
  7.05678474e-03 -1.05538001e+00]",-0.4473742128427902
ESTA.JK,593,148,0.6824324324324325,222,371,[-0.01149822 -0.11958749  0.00700643 -0.0026686   0.00110457 -0.56433252],-0.5221234984875042
ESTI.JK,910,227,0.8237885462555066,282,628,[-0.01891343 -0.02641586  0.0147246   0.0131234  -0.00540545 -0.53728211],-0.8007498231636712
ETWA.JK,597,149,0.5704697986577181,175,422,[ 0.4416136   0.016688   -0.00231999  0.18696018 -0.04605542 -1.45533139],-0.8898816695447929
EURO.JK,127,31,0.3870967741935484,69,58,[ 0.12815986 -0.32501255  0.73061992  0.09822247  0.05358253 -0.30916491],0.18579054821238225
EXCL.JK,966,241,0.5975103734439834,398,568,[-0.17030125 -0.0571253  -0.00576064 -0.04340027  0.00184973 -0.38028329],-0.36021119043699046
FAPA.JK,437,109,0.6146788990825688,189,248,[-0.00614484 -0.65213785 -1.00808053 -0.34038562 -0.01453859 -1.25687781],-0.26339868185488746
FAST.JK,967,241,0.7344398340248963,287,680,"[-5.10282025e-02  3.86363949e-02 -1.78652449e-02 -1.96178433e-02
  7.69036372e-04 -1.13449093e+00]",-0.8587486451932936
FASW.JK,817,204,0.8529411764705882,188,629,[ 0.0167605  -0.04632249  0.02040394 -0.04062409 -0.03043858  0.07095558],-1.208904991458823
FILM.JK,921,230,0.5260869565217391,369,552,[ 0.49409566  0.02714924 -0.00750218 -0.16332975  0.01174332  0.23409551],-0.4015055212513126
FIMP.JK,384,96,0.71875,118,266,[ 0.04566633  0.00636108  0.12293778  0.01827348  0.04859154 -0.93730618],-0.8224278579972203
FIRE.JK,966,241,0.7261410788381742,312,654,[-0.05528429 -0.009266    0.01847779  0.13213337  0.00237313 -0.35763963],-0.747015441770977
FISH.JK,966,241,0.7842323651452282,138,828,[ 0.17202908 -0.00958128  0.00295294  0.01329733 -0.0134866   0.32494062],-1.8076084586945416
FITT.JK,745,186,0.6505376344086021,240,505,[ 0.17532988  0.01985303 -0.09305242 -0.03565816  0.00237108 -0.20083057],-0.7526553164152378
FLMC.JK,200,49,0.7959183673469388,71,129,[ 0.16261106 -0.22320708  0.04580905  0.01565625 -0.01375947  1.18421361],-0.5963736634463218
FMII.JK,900,225,0.6977777777777778,204,696,[-0.24865323  0.06228517  0.06017106 -0.05332896  0.00080748  0.05586893],-1.2473572911581403
FOOD.JK,832,207,0.6280193236714976,260,572,[-0.22577795 -0.0302191  -0.0469316   0.00748399 -0.02073433  0.05456744],-0.7874643378437827
FORU.JK,960,239,0.6652719665271967,232,728,[-0.08441568  0.02971445 -0.01899443  0.00267914 -0.04727901 -1.28650017],-1.1552208430513833
FORZ.JK,317,79,0.810126582278481,114,203,[-0.00873836  0.01429344 -0.19573795  0.29625434  0.04361061  0.43566958],-0.5996774311697572
FPNI.JK,966,241,0.6265560165975104,343,623,"[-1.32022307e-01  9.05907740e-02 -5.97789547e-03  3.00308413e-02
 -1.13356350e-04 -5.39425785e-01]",-0.5992616562003676
FREN.JK,966,241,0.7178423236514523,366,600,[-0.0122279   0.01393431 -0.00828112 -0.00562088  0.00527942 -0.9051353 ],-0.49084991642468645
FUJI.JK,728,181,0.6519337016574586,279,449,"[-6.54152906e-02 -1.49484427e-02 -4.66280184e-02  6.27464794e-02
 -2.10121188e-03 -2.97789173e+00]",-0.4762135217563273
FUTR.JK,12,3,0.6666666666666666,5,7,[-0.00578978  0.18805597  0.07770069  0.0463711  -0.07065124  0.01598037],-0.3264707409266344
FWCT.JK,27,6,0.6666666666666666,7,20,[-0.01176091  0.09290282  0.05923925  0.07722459 -0.7562002  -0.15843879],-1.1254411327402596
GAMA.JK,246,61,0.9836065573770492,34,212,[-0.0054869   0.02993502  0.03492755  0.05365244 -0.11012429 -1.50395253],-1.9944366342715463
GDST.JK,966,241,0.6597510373443983,308,658,[-0.04236823 -0.05956992 -0.01423532  0.03025664  0.00146221 -1.22374787],-0.7638947018800567
GDYR.JK,890,222,0.6351351351351351,194,696,[-0.00206353 -0.00149126  0.0271571   0.15722104 -0.00129517 -0.1518313 ],-1.279512268142543
GEMA.JK,965,241,0.7302904564315352,222,743,[-0.21859721 -0.00453922 -0.06565881  0.00403789  0.00243425 -1.18805632],-1.2087519095075068
GEMS.JK,493,123,0.6910569105691057,161,332,[-0.00733369 -0.06434285 -0.19980401 -0.12855852  0.00684727  0.74045395],-0.723731095724458
GGRM.JK,966,241,0.5767634854771784,419,547,[-0.00697291  0.05095911  0.06708756 -0.03550088 -0.00440064 -0.14460447],-0.2662112628353696
GGRP.JK,688,172,0.6627906976744186,269,419,[-0.11664868 -0.03279843  0.01241769  0.00418419 -0.00888681 -0.826859  ],-0.4383640024946825
GHON.JK,966,241,0.6680497925311203,288,678,[-0.46557391 -0.00496097 -0.00178401 -0.00203136  0.00637867 -1.531905  ],-0.8490932893340557
GIAA.JK,693,173,0.7687861271676301,241,452,[ 0.05633108 -0.00717237  0.00655711 -0.00369069 -0.01910369  0.44173053],-0.6294574695364411
GJTL.JK,966,241,0.6224066390041494,366,600,[-0.11257589  0.00883137  0.01616118 -0.0198682   0.01106159 -0.13850974],-0.49198568208482485
GLOB.JK,966,241,0.6846473029045643,320,646,"[-5.15518377e-01  1.90031257e-04 -9.96850617e-02 -1.81960890e-03
  4.28808524e-02 -6.74352113e-01]",-0.7004269865609248
GLVA.JK,635,158,0.5189873417721519,225,410,"[-2.09742850e-01 -9.49849643e-03 -7.24132240e-02  1.93211460e-03
 -4.03488340e-03 -2.32063235e+00]",-0.594830862270144
GMFI.JK,965,241,0.7717842323651453,314,651,[-0.00452151  0.01685426 -0.03432844 -0.0119152  -0.00239092 -0.846482  ],-0.7237317451928974
GMTD.JK,601,150,1.0,71,530,[-0.15204841  0.09908878 -0.04687238 -0.09749507 -0.02812478 -0.36037534],-2.055136454330182
GOLD.JK,967,241,0.6431535269709544,296,671,[-0.40950082  0.00647985 -0.01280862 -0.02238346 -0.00300873 -2.61323938],-0.8312299546292522
GOOD.JK,885,221,0.6515837104072398,343,542,[-0.11890444 -0.15311502  0.34462386  0.03652849 -0.0022157  -0.25000733],-0.4623482463079034
GOTO.JK,187,46,0.5434782608695652,67,120,[ 0.06884841 -0.01512742 -0.4030041   0.15191136 -0.05864738 -0.2468337 ],-0.6029652750111979
GPRA.JK,964,240,0.6708333333333333,281,683,"[-4.20327870e-02 -1.30241379e-02  3.22669242e-05 -4.09803944e-02
  9.56730337e-03 -2.14451156e+00]",-0.8928207592259307
GPSO.JK,307,76,0.631578947368421,104,203,"[-1.21359958e-01  1.01090252e-02  5.93322276e-02  1.75888008e-01
 -7.73533114e-04 -7.96804163e-01]",-0.6610074660924254
GSMF.JK,963,240,0.6916666666666667,271,692,[-0.30144353 -0.03661116 -0.00262316  0.05350036  0.00949344  0.07533512],-0.9496007614840297
GTBO.JK,510,127,0.6220472440944882,170,340,"[-1.63861284e-01  1.19866785e-03 -3.37706663e-02 -4.92992305e-02
  7.01073563e-02 -2.01947301e+00]",-0.6980933139695086
GTSI.JK,305,76,0.8552631578947368,80,225,[-0.07621626 -0.02111343  0.00512838  0.0395853   0.17269567  0.32913623],-1.046026877359239
GULA.JK,129,32,0.625,63,66,[ 0.03513787 -1.09881633  0.30415025 -0.00786917 -0.01701374 -0.71093251],0.004678868115553789
GWSA.JK,964,241,0.6016597510373444,323,641,"[-9.87724690e-02 -1.53786744e-02 -1.01397837e-01  2.46562457e-02
 -5.52716925e-04 -1.92209535e+00]",-0.6838634466469072
GZCO.JK,569,142,0.5845070422535211,152,417,[ 0.10869564 -0.04906571 -0.1610194   0.01319299  0.01713709 -1.16562355],-1.0244788044207704
HAIS.JK,309,77,0.6233766233766234,111,198,[-0.08466632 -0.18489162 -0.00472876 -0.03144461 -0.04862229  0.09357932],-0.5729869847943617
HALO.JK,23,5,0.4,13,10,[ 0.04084596 -0.25493009  0.19645647  0.19184813 -0.70892672  0.16497126],0.43573187488334125
HATM.JK,134,33,0.5757575757575758,39,95,[-0.0491609   0.10646805 -0.17148311 -0.38038253 -0.02985606 -0.20604595],-0.9172450453038534
HDFA.JK,956,239,0.6192468619246861,254,702,[-0.57657718 -0.01064766  0.06385436  0.0165748   0.00757014 -0.65213866],-1.0191028106218691
HDIT.JK,711,177,0.7796610169491526,243,468,[ 0.04578717  0.00327126  0.08285824 -0.05005359 -0.01224943 -0.3260057 ],-0.6692197916728111
HEAL.JK,967,241,0.5684647302904564,379,588,[ 0.00450875 -0.06982328  0.01084576  0.06998568 -0.01081006 -0.30299239],-0.4429494546829637
HELI.JK,965,241,0.6556016597510373,356,609,[-0.02426559 -0.00696846 -0.01107606 -0.00165816 -0.002211   -1.47651222],-0.5344361177217957
HERO.JK,965,241,0.6804979253112033,310,655,[-0.24964278 -0.07554683  0.01581881  0.09016516  0.00203929 -1.83272881],-0.7606147224555883
HEXA.JK,966,241,0.6224066390041494,390,576,"[-1.09255840e-02  1.00232821e-04  1.38770480e-02  7.22606476e-03
  1.58480044e-02 -8.28047240e-01]",-0.3902602968701679
HILL.JK,11,2,0.5,7,4,[0.04231161 0.03344988 0.541715   0.51481672 0.82688065 0.17187123],0.277861482022843
HITS.JK,962,240,0.6833333333333333,257,705,"[-5.08448805e-01  1.04435020e-02 -9.68529557e-05  5.61537576e-02
 -2.61460830e-03 -8.97374204e-01]",-1.0094521148434288
HKMU.JK,658,164,0.7987804878048781,220,438,[ 0.09205345  0.00932345  0.01726472 -0.00325735  0.01809078 -0.77295431],-0.6837280645601866
HMSP.JK,967,241,0.6265560165975104,372,595,[-0.01684991  0.0442798   0.01835081 -0.06121847  0.00107708  0.35462297],-0.4781723690384267
HOKI.JK,967,241,0.7012448132780082,355,612,[-0.10942691 -0.00609571 -0.01974847  0.02475985  0.00355886 -0.42722652],-0.5409911374867054
HOME.JK,298,74,0.8108108108108109,98,200,[ 0.07963156 -0.04738126  0.03947338 -0.00256509  0.01932104  0.24458227],-0.7137450240872316
HOMI.JK,496,124,0.5806451612903226,245,251,[ 0.20717952 -0.04682861 -0.04350134  0.3137184   0.0290123   1.30692194],-0.04317262302040811
HOPE.JK,315,78,0.8205128205128205,92,223,[ 0.01945964 -0.07859501 -0.00825165  0.008323    0.04270015  0.52911529],-0.8989031965934033
HOTL.JK,437,109,0.8807339449541285,141,296,[-0.10230333 -0.07756908 -0.00944434 -0.00366812  0.05827719 -0.51880329],-0.7420707451636798
HRME.JK,748,186,0.7849462365591398,217,531,[ 0.62587032  0.01813553  0.11333376 -0.00645792 -0.03126475 -0.24904008],-0.8975300997498207
HRTA.JK,965,241,0.6473029045643154,349,616,[-0.06476147  0.00201627  0.01997311  0.09485414  0.00612558 -0.88402844],-0.5640277497329188
HRUM.JK,967,241,0.5560165975103735,370,597,[ 0.2039225   0.00714263 -0.02650208  0.00512851  0.04052188 -0.03100727],-0.47606839869077633
IATA.JK,309,77,0.7402597402597403,100,209,[-0.09374146 -0.14085998  0.11892362 -0.09205017  0.00848687  0.29692807],-0.745610667249413
IBFN.JK,740,185,0.6756756756756757,183,557,"[-2.59452529e-01 -8.39667166e-04  1.71732021e-02  4.27870388e-02
 -8.99051319e-03 -9.77313682e-01]",-1.1106933226222504
IBOS.JK,180,44,0.5681818181818182,66,114,[ 0.08168568  0.01372918  0.17847045 -0.1935904  -0.07187162  0.15325926],-0.5484306308640797
IBST.JK,739,184,0.782608695652174,100,639,[ 0.30906287  0.01251606 -0.02012734  0.12458238 -0.01162405  0.00589183],-1.876550891472848
ICBP.JK,966,241,0.5518672199170125,421,545,[-0.12761037 -0.01228549 -0.07737332  0.04609691 -0.00248334 -1.17693659],-0.25923082225059035
ICON.JK,966,241,0.7593360995850622,304,662,"[-3.54967459e-01  1.05309140e-02 -4.75581253e-02 -1.79697514e-02
 -5.86438912e-04 -3.01576811e+00]",-0.7947079391034074
IDEA.JK,304,76,0.618421052631579,103,201,[-0.04255991 -0.0045312   0.0067846   0.05435674 -0.0467905   0.0055636 ],-0.6614249908940676
IDPR.JK,966,241,0.6224066390041494,271,695,"[-2.26267290e-02 -2.28780263e-03  6.12858915e-04 -1.08290748e-01
  3.57872585e-03 -8.86607773e-01]",-0.9460978219631037
IFII.JK,642,160,0.575,239,403,[-0.06969515  0.04227169  0.00474082  0.03391303  0.02178195 -0.94964868],-0.5253501485791843
IFSH.JK,644,161,0.6645962732919255,202,442,"[ 8.72417588e-02 -3.18810061e-02 -1.06938626e-01  4.23965829e-04
 -4.64650398e-02 -9.27438902e-01]",-0.7928746309303012
IGAR.JK,966,241,0.6556016597510373,365,601,"[-4.18418904e-02 -2.25937723e-04  6.16385431e-03 -5.20214899e-02
  7.07174943e-03 -2.15549485e+00]",-0.4912810491117062
IIKP.JK,245,61,0.8852459016393442,89,156,[ 0.0525636   0.00745357  0.04573338  0.45955032 -0.06056097  0.02757596],-0.5954470787644821
IKAI.JK,377,94,0.8404255319148937,108,269,[ 0.09187829  0.04704147 -0.00179733  0.00945988 -0.01389663 -0.19255424],-0.9224545965388575
IKAN.JK,608,151,0.7284768211920529,193,415,[ 0.20500857  0.02709195  0.04567285  0.04469002 -0.02613959 -0.18571424],-0.7798702613890437
IKBI.JK,966,241,0.6556016597510373,267,699,"[-2.25350966e-01 -8.64897442e-02 -4.04908089e-04  2.29624255e-03
  3.25842606e-03 -2.27504225e+00]",-0.9708590343469788
IMAS.JK,966,241,0.5269709543568465,359,607,[-0.0039522   0.00042536  0.01000078 -0.04093808 -0.00736613  0.10597208],-0.5253867249788511
IMJS.JK,966,241,0.5892116182572614,326,640,[-0.09941348 -0.00345918 -0.01115455 -0.01040851 -0.02166454 -0.10399846],-0.6771829945631843
IMPC.JK,966,241,0.6431535269709544,373,593,[ 0.01208235 -0.01171483 -0.07078586 -0.03213451 -0.00213835  0.10515959],-0.4612167771469194
INAF.JK,966,241,0.7053941908713693,349,617,[0.31732192 0.00840472 0.01067303 0.14710763 0.01042749 0.5254441 ],-0.5759534764091834
INAI.JK,964,241,0.7261410788381742,341,623,"[-2.20661650e-01  2.34633429e-05 -1.04064155e-02  3.65570083e-02
  3.48755503e-03 -3.23788406e+00]",-0.597485171057448
INCF.JK,827,206,0.7718446601941747,248,579,[ 0.65153569  0.02855086 -0.06353111  0.28385705  0.04032923 -1.15019843],-0.8717810215961761
INCI.JK,966,241,0.6473029045643154,347,619,[-0.30245475 -0.04811235  0.02530067 -0.0275408  -0.00173148 -1.69844588],-0.569027999279039
INCO.JK,966,241,0.5726141078838174,410,556,[-0.00138421  0.0257197  -0.01774127 -0.03011946 -0.01371558  0.63569581],-0.3052829315878339
INDF.JK,966,241,0.5767634854771784,418,548,[-0.03970268  0.00145636  0.00566252  0.00553324  0.0012402   0.10592647],-0.27058156757953655
INDO.JK,626,156,0.6346153846153846,243,383,[ 0.0084229   0.09696171 -0.00463032  0.009566    0.00109954 -0.38547069],-0.46345718249695633
INDR.JK,966,241,0.6307053941908713,368,598,[ 0.00034133  0.12318672 -0.00752911 -0.02940837  0.0018304  -0.13322211],-0.4802784171531875
INDS.JK,966,241,0.5933609958506224,344,622,"[-5.93923873e-02 -1.68969781e-05 -4.29273309e-04 -8.40829023e-02
 -4.09039919e-04 -1.66715147e+00]",-0.5923702865391988
INDX.JK,955,238,0.6890756302521008,283,672,"[-8.37971596e-03  2.06458292e-02  2.39053086e-04 -1.28345423e-02
 -2.50813462e-03 -1.42273994e+00]",-0.869737122897584
INDY.JK,966,241,0.5311203319502075,404,562,[-0.05957613 -0.03504794 -0.02534214 -0.00304501  0.02599692 -0.0372781 ],-0.33487427358567556
INKP.JK,966,241,0.6058091286307054,396,570,[-0.21101916  0.07596435 -0.03277558  0.03835793 -0.00240954 -0.29458378],-0.3588696220393854
INOV.JK,729,182,0.6593406593406593,278,451,[-0.175286    0.00927935  0.08885806 -0.00694846  0.01081543 -1.35900277],-0.48124421900573555
INPC.JK,952,238,0.7436974789915967,249,703,"[-1.24892045e-01  1.63790611e-02  4.57093690e-03  1.04492927e-01
 -4.69711876e-04 -1.32575740e+00]",-1.0361999105229953
INPP.JK,961,240,0.6958333333333333,210,751,[-0.52262043 -0.01805614  0.010003   -0.01784954  0.00265924 -1.70651911],-1.2747946002856587
INPS.JK,966,241,0.7551867219917012,266,700,[ 0.68244668 -0.03042085  0.02663955  0.10920573  0.00463174 -0.41232189],-0.9586859000946079
INRU.JK,966,241,0.6597510373443983,204,762,[-0.10908974  0.09706252 -0.01672976 -0.02335995  0.00219075 -0.13466581],-1.3215246389426376
INTA.JK,814,203,0.7093596059113301,209,605,[-0.14711972  0.00533821  0.11971066 -0.065427   -0.00298627 -1.30007474],-1.0639189331232222
INTD.JK,966,241,0.6929460580912863,298,668,[-0.16994367 -0.02361322 -0.00706289 -0.00129783  0.00745672 -0.67650857],-0.8101267311568077
INTP.JK,966,241,0.5518672199170125,427,539,"[-4.32106081e-02 -1.66031491e-02  1.35185591e-02  7.88264898e-02
 -1.09242769e-04 -6.15534416e-01]",-0.22625676660296956
IPAC.JK,343,85,0.6470588235294118,114,229,[ 0.1962072  -0.04920384 -0.02941521 -0.00219353  0.00302216 -0.85329575],-0.7106962496516915
IPCC.JK,938,234,0.6239316239316239,348,590,[-0.00574596 -0.02800455  0.02353409  0.04705662 -0.00491606 -0.47295267],-0.5266693485886357
IPCM.JK,966,241,0.6804979253112033,357,609,[ 0.09740567  0.04044622 -0.01534702 -0.00362198 -0.00531398 -0.22701016],-0.537853828987711
IPOL.JK,965,241,0.6390041493775933,336,629,[-0.09794698 -0.02011697  0.03886681  0.02856636  0.0098021  -2.377066  ],-0.6292313480478473
IPPE.JK,237,59,0.9322033898305084,86,151,[ 0.09774537 -0.08786525 -0.07133468  0.10194574 -0.03860443  0.00645966],-0.5825087401069602
IPTV.JK,726,181,0.7790055248618785,205,521,[-0.00129937 -0.00204443 -0.04153449  0.03108463  0.00419007 -0.54313452],-0.9385754345239294
IRRA.JK,674,168,0.6666666666666666,267,407,[-0.06249939  0.02267383 -0.07306008 -0.12982706  0.00622056  0.07533855],-0.4279473215173042
IRSX.JK,24,5,1.0,9,15,[ 0.01300424 -0.75132036 -0.33329903  0.31817743 -0.32346836  0.03925713],-0.760605751540127
ISAP.JK,56,14,0.7142857142857143,15,41,[-0.03240244 -0.10493904 -0.08307349  0.58989137  0.3081158   0.4707403 ],-1.0208249470803585
ISAT.JK,965,241,0.5394190871369294,390,575,[-0.00304829  0.00882154  0.09710611 -0.00488002 -0.00201326  0.03464216],-0.39108062809725463
ISSP.JK,966,241,0.6390041493775933,357,609,"[-2.61506134e-01  3.28747539e-02  9.77882999e-04  3.13679439e-03
 -1.53201869e-02 -1.28776586e+00]",-0.5257414703907598
ITIC.JK,732,182,0.5989010989010989,282,450,[ 0.24540131 -0.05692514  0.00174998  0.01184597  0.01204764 -0.20863004],-0.47317837514204664
ITMA.JK,927,231,0.6666666666666666,338,589,"[-8.93532168e-06  5.77354583e-05 -1.57614436e-03  2.08283449e-04
  7.45061316e-04 -1.08825596e-04]",-0.0025204042761939726
ITMG.JK,966,241,0.5103734439834025,441,525,[ 0.0524293   0.000927   -0.03034476  0.00768219 -0.00838344  0.29785539],-0.17044764376887053
JARR.JK,128,32,0.78125,36,92,[-0.03154875  0.03883235  0.15715567  0.56395109  0.00506952  0.52140699],-0.9684008687012862
JAST.JK,760,189,0.6772486772486772,253,507,[ 0.54624429 -0.01542141 -0.05028822  0.13325156 -0.01281716  0.30440068],-0.7075375549420336
JAWA.JK,966,241,0.6639004149377593,280,686,[-0.1359306  -0.00212753 -0.00792542 -0.02028378  0.00942993 -1.19205123],-0.8909925759754426
JAYA.JK,808,201,0.6268656716417911,285,523,[-0.216642   -0.00163818  0.13433161  0.09772433 -0.01051359 -0.774172  ],-0.6037577453548792
JECC.JK,829,207,0.7729468599033816,107,722,[-0.35942908 -0.00584167 -0.01598976  0.01094329  0.00738882 -0.03883117],-1.9027849039346616
JIHD.JK,967,241,0.6597510373443983,230,737,[-0.19205464 -0.02763885  0.01265994  0.01234446 -0.07126653 -1.7516724 ],-1.1877171701303588
JKON.JK,960,239,0.5899581589958159,196,764,[-0.2941432  -0.0303942   0.00236699 -0.01372503  0.00737845 -1.12928782],-1.363003548929063
JKSW.JK,191,47,0.8085106382978723,57,134,[-0.07319036 -0.01774183 -0.05063604 -0.95855225  0.03058815 -1.3966159 ],-0.8950849517136444
JMAS.JK,966,241,0.7178423236514523,254,712,[-0.45204637  0.00356756 -0.00378672  0.09710245  0.01835628 -2.00360385],-1.0268263725964857
JPFA.JK,967,241,0.5892116182572614,406,561,[-0.08158907 -0.00986235  0.00579882  0.02839883  0.00183905 -0.02967239],-0.3148950260380581
JRPT.JK,966,241,0.6721991701244814,317,649,[-0.00115266  0.0299567   0.03520941 -0.01668512  0.03685493 -0.97745977],-0.7091141133791222
JSKY.JK,829,207,0.7632850241545893,289,540,[ 0.00138997  0.06240985  0.04853933  0.09938109  0.00041069 -0.00513689],-0.6292064296684388
JSMR.JK,966,241,0.6224066390041494,420,546,[-0.08990386 -0.0289804  -0.03293274 -0.00241744  0.020753    0.01613795],-0.26934243494450366
JSPT.JK,940,235,0.8468085106382979,107,833,[-0.12385445  0.02886799  0.00281619  0.05035419 -0.00183042 -1.72715346],-2.0703920057617187
JTPE.JK,967,241,0.7302904564315352,296,671,"[ 3.74357217e-01  3.84763280e-04  2.85882641e-03 -2.89293192e-01
  2.10099107e-02  6.88031698e-01]",-0.8485747101678249
KAEF.JK,966,241,0.7012448132780082,341,625,[ 0.11243041  0.025843   -0.05564512  0.00870223  0.00468596 -0.08990906],-0.6079491835759507
KARW.JK,945,236,0.7033898305084746,289,656,[-0.02125537 -0.00208196 -0.01208602 -0.09229668 -0.00192614 -1.22592193],-0.8153828566722233
KAYU.JK,538,134,0.8582089552238806,159,379,[-0.3349479   0.12313978  0.0071612  -0.01820957  0.00604035 -0.42336375],-0.8760287103276846
KBAG.JK,294,73,0.9452054794520548,69,225,[ 0.20508475 -0.00966354  0.15279323  0.36391    -0.08907258 -0.26536572],-1.190576354612254
KBLI.JK,967,241,0.6597510373443983,327,640,[-0.12299778 -0.00237491  0.0138147  -0.08404181 -0.00139894 -1.15046823],-0.668052939514995
KBLM.JK,966,241,0.6224066390041494,364,602,[-0.31937035  0.01864089 -0.00308116 -0.0132935  -0.01793537 -2.92570617],-0.49710632720194553
KBLV.JK,964,241,0.6887966804979253,264,700,[-0.20069618 -0.00720826 -0.00832588 -0.02567435  0.00238005  0.01131997],-0.9856518507575035
KDSI.JK,966,241,0.6348547717842323,363,603,[-0.1460185  -0.0017298  -0.00859413 -0.00648183 -0.00218432 -1.43018141],-0.5039432057835171
KDTN.JK,74,18,0.5555555555555556,25,49,[-0.02469249 -0.17609324  1.10646408  0.46570219  0.03165356 -0.2720565 ],-0.6352482444085223
KEEN.JK,699,174,0.6206896551724138,275,424,[-0.01744068 -0.0807009   0.00816819  0.18855032  0.03231949 -1.57004433],-0.43255220757026225
KEJU.JK,651,162,0.6604938271604939,249,402,[-0.007394    0.02592828 -0.01291329 -0.10172997 -0.00690508 -1.29116338],-0.48520766687183814
KETR.JK,73,18,0.5555555555555556,20,53,[-0.04530774 -0.07307018 -0.07555047 -0.57442469  0.21499414 -0.38022268],-0.9240793555539152
KIAS.JK,284,71,0.9154929577464789,66,218,[-0.14038425 -0.2072888   0.06672328  0.33464831  0.01018775 -1.36393495],-1.234266294090618
KICI.JK,966,241,0.6307053941908713,282,684,[-0.38440301  0.00722591 -0.02363024 -0.00436015  0.00497379  0.14132624],-0.8941998643867428
KIJA.JK,966,241,0.8589211618257261,303,663,[-0.08888909 -0.04856505 -0.00490594 -0.00577242  0.02785339 -0.43876622],-0.7874101829951622
KING.JK,18,4,0.25,10,8,[-0.0179364  -0.08086263 -0.09334811 -0.04328414 -0.26001576  0.0437344 ],0.22998638866139803
KINO.JK,966,241,0.6265560165975104,371,595,[ 0.12867544 -0.01615153 -0.02818502  0.04287398  0.01836452  0.47618717],-0.4751706016896263
KIOS.JK,966,241,0.6307053941908713,272,694,[ 0.05355765  0.01957236 -0.01647972 -0.00416384 -0.04159595 -0.26504187],-0.9391455470378524
KJEN.JK,704,176,0.6534090909090909,162,542,[ 0.40162978 -0.00666614  0.04290113  0.09473005 -0.0137547  -0.05896756],-1.2081838993780294
KKES.JK,127,31,0.6774193548387096,48,79,[-0.02735012  0.00908249  0.37029123  0.40090683  0.052521   -0.43405954],-0.4996270413237436
KKGI.JK,966,241,0.5767634854771784,386,580,"[-7.68563208e-02  1.13154143e-02  2.24522769e-02  1.93259930e-02
  1.74488014e-04 -1.11266943e+00]",-0.40596966038125676
KLBF.JK,967,241,0.5352697095435685,416,551,"[-2.02114352e-02  3.24263838e-02  1.43088085e-02 -2.59010793e-02
 -4.12957931e-04 -1.25277233e+00]",-0.2732226230866203
KLIN.JK,126,31,0.45161290322580644,20,106,[-0.05732823 -0.83720657  0.69471856  0.28045121 -0.2144179  -0.89008858],-1.7194672355385217
KMDS.JK,500,124,0.6532258064516129,205,295,[-0.07657057  0.02855077  0.1333958  -0.04050373 -0.02792535 -1.90138982],-0.3660277202747252
KMTR.JK,965,241,0.6846473029045643,340,625,[-0.0177042   0.00567958 -0.03105814 -0.03894383 -0.00606545 -0.65147274],-0.5993879175963439
KOBX.JK,966,241,0.6182572614107884,376,590,[-0.17839259 -0.00641008  0.03040502  0.00262331  0.0122998  -1.63033274],-0.4474818057500621
KOIN.JK,868,216,0.6990740740740741,206,662,[-0.25204699  0.01761251 -0.02972005  0.07304127  0.02536574 -0.54667696],-1.162753332456655
KONI.JK,947,236,0.6864406779661016,231,716,[ 0.55569076 -0.01830989  0.02626571  0.01290976 -0.00539627  0.03629878],-1.1356579332713295
KOPI.JK,965,241,0.6970954356846473,260,705,"[-1.68771687e-01 -3.36222730e-03  9.45001038e-04 -1.66885210e-02
 -5.97143801e-03 -1.02992825e+00]",-0.9945492956270253
KOTA.JK,502,125,0.808,180,322,[ 0.35792705 -0.02707903  0.07810163 -0.03126262 -0.02277595  0.53067389],-0.5960250737257291
KPAL.JK,528,131,0.9083969465648855,178,350,[ 0.17395679 -0.01096396  0.13007503  0.06046352 -0.01181803 -0.71324475],-0.6670095497546042
KPAS.JK,545,136,0.7573529411764706,127,418,[-0.08332633 -0.03072933  0.01455318  0.04754009  0.01167057 -0.1256283 ],-1.1945494296025394
KPIG.JK,966,241,0.7219917012448133,274,692,[-0.18861828 -0.08335715  0.0353747  -0.13100612  0.00288605 -0.64436197],-0.9365338657445309
KRAH.JK,456,113,0.8495575221238938,121,335,[ 0.33094391  0.02081863  0.06687921 -0.10402171  0.13592777 -0.01027224],-1.029319020440347
KRAS.JK,966,241,0.6639004149377593,361,605,[ 0.05374825  0.05779164  0.00811557 -0.00671059  0.00491705 -0.06113568],-0.5121391615276586
KREN.JK,829,207,0.855072463768116,280,549,[ 0.09597098 -0.00715907 -0.03804831  0.0056896   0.00119943  0.50323284],-0.6822885110750215
KRYA.JK,134,33,0.696969696969697,43,91,[ 0.18929446 -0.54939475 -1.23509727  0.57657134 -0.24300389  0.64820735],-0.8581318509213561
KUAS.JK,280,69,0.7681159420289855,90,190,[ 0.02984356  0.08117402  0.10920566  0.00955921 -0.07231604 -1.19628304],-0.7759311763419646
LABA.JK,353,88,0.6931818181818182,115,238,[ 0.35544265  0.11693893  0.07008099  0.03058721 -0.07207441 -0.41271961],-0.7327574369307545
LAJU.JK,29,7,0.8571428571428571,11,18,[-0.03044138 -0.02878823  0.68506308  0.41219129 -0.24890292  0.24621092],-0.4811454658262377
LAND.JK,828,206,0.7233009708737864,289,539,[-0.2493327   0.02931943  0.16577003 -0.0588846  -0.04999152  0.26115204],-0.6152088148042995
LCGP.JK,191,47,0.8723404255319149,69,122,[-0.03152767 -0.01932966 -0.12070022 -0.0200898  -0.04011827 -1.55054417],-0.5614142461723032
LCKM.JK,960,240,0.6833333333333333,245,715,[-0.00377216  0.00028383 -0.00467757  0.01308874  0.00360977 -0.21515715],-1.057825202801937
LEAD.JK,585,146,0.7123287671232876,140,445,[ 0.06868791  0.02878426 -0.00547487 -0.07825485 -0.00646841 -0.58057638],-1.159747168275937
LFLO.JK,387,96,0.6875,137,250,[-0.00310011  0.01317989  0.05175008  0.14842821  0.03336235  0.2207053 ],-0.5839972528062523
LIFE.JK,720,180,0.8888888888888888,111,609,[-0.00056965  0.04707438  0.03926892 -0.00060503 -0.05236475 -0.26596868],-1.6997382902400857
LINK.JK,966,241,0.6265560165975104,388,578,[-0.01048332  0.0055549  -0.01373111  0.00202249  0.00807606 -0.56192092],-0.3889173350775226
LION.JK,967,241,0.6265560165975104,257,710,[-0.33249515 -0.05453915 -0.0114653   0.03329084 -0.03336154 -1.30243923],-1.0186562344879357
LMAS.JK,612,152,0.7960526315789473,143,469,"[-4.32514215e-02  5.14769261e-02 -1.48880657e-02 -8.78657391e-03
  2.47972765e-05 -2.14750637e+00]",-1.2080728366335074
LMPI.JK,967,241,0.6680497925311203,317,650,"[-1.11366251e-01  7.20410205e-03  2.47828466e-04 -3.06266975e-02
  1.23266183e-02 -2.70449260e+00]",-0.7225167579845491
LMSH.JK,967,241,0.6804979253112033,221,746,"[ 1.86261724e-04  4.75246799e-06 -1.48082409e-05  2.65383550e-02
  6.52321387e-03 -2.90191202e-02]",-1.213544231633111
LPCK.JK,967,241,0.6182572614107884,391,576,[ 0.17356383  0.09120952 -0.00901692 -0.01127091  0.01322938  0.06566652],-0.3799411764022511
LPGI.JK,915,228,0.618421052631579,196,719,[ 0.09214191  0.03889546  0.01544432  0.01226001 -0.01805341 -0.58677089],-1.304212868941393
LPIN.JK,965,241,0.6514522821576764,307,658,[ 0.09729102  0.10556633 -0.03203205 -0.02484196 -0.00860453 -1.10070917],-0.7612045841248073
LPKR.JK,967,241,0.6804979253112033,339,628,[-0.07948689 -0.00991371 -0.01162666  0.01668825 -0.00341411 -0.34423547],-0.618196160138267
LPLI.JK,956,239,0.6317991631799164,299,657,[-0.25591873 -0.01811033 -0.01787044  0.07254746 -0.01481015 -1.51758058],-0.7935595383739144
LPPF.JK,966,241,0.5560165975103735,407,559,"[ 1.71007167e-01  1.68449363e-02  3.85750739e-02 -2.80142361e-02
 -2.26961099e-04  6.44678869e-01]",-0.3238050770373023
LPPS.JK,966,241,0.7095435684647303,308,658,"[-2.15958656e-01  7.38214697e-04 -8.76759028e-03 -5.80717282e-02
  9.44555144e-03 -2.01323507e+00]",-0.7514158441247557
LRNA.JK,964,241,0.7136929460580913,307,657,"[-2.23368841e-01 -1.60031847e-03  1.50005402e-06 -4.50400874e-02
 -2.31813288e-02 -2.44141152e+00]",-0.7611588648905633
LSIP.JK,966,241,0.6265560165975104,414,552,[-0.00559869  0.00741308  0.00024066 -0.02567196  0.00578384 -0.10115573],-0.2870067437469378
LTLS.JK,966,241,0.6265560165975104,354,612,"[-1.06512769e-01 -4.63888151e-02 -7.11263637e-02 -1.52459694e-04
  7.17489683e-03 -8.88509911e-01]",-0.5525215915033619
LUCK.JK,856,214,0.719626168224299,302,554,[ 0.26022897  0.01265018 -0.00998325 -0.01817451 -0.01337148 -0.96439647],-0.5984511445982795
LUCY.JK,371,92,0.5978260869565217,149,222,[ 0.17982898 -0.01206807 -0.05184904 -0.00464954 -0.038858    0.63711444],-0.4251525018830655
MABA.JK,230,57,0.9473684210526315,50,180,[-0.01881128 -0.07872868  0.18613001  0.36429498  0.01519273  0.06943477],-1.2861787732283818
MAIN.JK,965,241,0.6680497925311203,391,574,[-0.07453128  0.05519122 -0.01304568 -0.03934233 -0.00446298 -0.61012473],-0.37885352995805033
MAMI.JK,322,80,0.575,132,190,[ 0.12445455  0.05105     0.11419365 -0.24179949  0.02705105  0.51842729],-0.3665790442879788
MAPA.JK,940,234,0.5341880341880342,319,621,[ 0.00064761  0.02282554  0.00244041  0.00079321  0.00150312 -0.00520613],-0.6696875317751944
MAPB.JK,966,241,0.6141078838174274,263,703,"[-6.26709315e-02 -1.94629963e-02  1.26112156e-04 -9.69666964e-04
 -1.76806700e-03 -1.85234738e+00]",-0.9827779299443916
MAPI.JK,966,241,0.5269709543568465,381,585,[-0.16736409  0.0357513   0.00517291 -0.03142766 -0.00365465 -0.10403856],-0.4361143557956163
MARI.JK,909,227,0.6343612334801763,319,590,[ 0.37039191  0.06309258  0.02179386 -0.00622534 -0.00121378 -0.64788242],-0.6206262966141578
MARK.JK,966,241,0.6182572614107884,392,574,"[ 1.07178360e-02  1.89755722e-03  5.55451457e-03 -4.08161350e-02
  8.01730007e-05  8.34733625e-02]",-0.38335067726114463
MASA.JK,924,230,0.6434782608695652,309,615,[-0.00596907 -0.01651309  0.00133172  0.03636054  0.01063815  0.0814473 ],-0.6938772516472461
MASB.JK,343,85,0.7058823529411765,92,251,[-0.01544438 -0.01490754 -0.03858338 -0.07864734  0.06463789 -2.29788515],-1.0234501730915717
MAYA.JK,923,230,0.6608695652173913,176,747,[ 0.34038811  0.02484613  0.05761049 -0.00199902  0.07970519 -0.10150846],-1.4469849390198213
MBAP.JK,966,241,0.5726141078838174,416,550,[ 0.08018948 -0.00433424  0.00246664 -0.00078016 -0.00178285  0.04802302],-0.2772606380613972
MBSS.JK,966,241,0.6390041493775933,364,602,[-0.11464466  0.0151779  -0.00319569 -0.00669829 -0.03863929 -0.29775508],-0.5065005994947277
MBTO.JK,965,241,0.6265560165975104,349,616,"[-5.52640482e-01  4.43074457e-03  3.82204352e-02  4.46675331e-02
  1.54008636e-03 -2.60508398e+00]",-0.565861430107331
MCAS.JK,965,241,0.6182572614107884,414,551,[ 0.49264399  0.00446596 -0.02063134  0.00475434 -0.02216445  1.59176464],-0.2969566707565035
MCOL.JK,306,76,0.5789473684210527,141,165,[ 0.04821522 -0.01155966 -0.0012      0.08018817  0.00573003 -0.41151373],-0.14977892050529532
MCOR.JK,966,241,0.7261410788381742,307,659,[-0.12262214  0.0169077   0.02029539  0.02212968  0.00306335  0.22045761],-0.7640660538267693
MDIA.JK,655,163,0.8895705521472392,192,463,[-0.24692962  0.06135653 -0.00891987  0.07172923  0.00579077 -1.16826792],-0.8828202360433886
MDKA.JK,967,241,0.6016597510373444,431,536,[-0.18509543  0.09508217 -0.00625002 -0.00104824 -0.00875099 -0.49908799],-0.22278663395159276
MDKI.JK,964,241,0.6514522821576764,344,620,[-0.23047413  0.02753089  0.02858792  0.04061761 -0.00359256 -2.34464763],-0.5902599329729878
MDLN.JK,747,186,0.6881720430107527,226,521,[ 0.250545   -0.03069777 -0.03972297  0.02359412  0.00320171 -0.95004161],-0.8322061501171131
MEDC.JK,967,241,0.5269709543568465,378,589,[ 0.05230832 -0.03246498  0.09233165  0.03161727  0.04026964 -0.83591138],-0.4384768015411312
MEDS.JK,125,31,0.6774193548387096,47,78,[-0.02685644 -0.19242348  0.25634235 -0.39707066  0.1900758   0.5357051 ],-0.44768624075630103
MEGA.JK,952,238,0.6218487394957983,228,724,[-0.21664645  0.03733715 -0.03086238 -0.00157849  0.00222462  0.00440235],-1.1643894834709037
MERK.JK,966,241,0.5477178423236515,340,626,[ 0.05122825  0.00512158  0.0174767  -0.03537119  0.01520333 -0.32686003],-0.609608701905082
META.JK,965,241,0.6639004149377593,322,643,[ 0.09540973 -0.02320656  0.11722182  0.018922   -0.00096274 -0.79758761],-0.6892076134663879
MFIN.JK,966,241,0.6431535269709544,293,673,[-0.02734213 -0.00928792  0.04256702 -0.01882071 -0.01283408 -2.23464805],-0.8322751205678833
MFMI.JK,966,241,0.6307053941908713,322,644,[-0.09658124  0.02430058  0.03193625  0.03360774  0.0083816  -1.56155231],-0.6887871786085551
MGLV.JK,354,88,0.75,142,212,[-0.03194731  0.1247903  -0.01715638 -0.03554763  0.00172211  0.80930212],-0.4090450344317153
MGNA.JK,85,21,1.0,7,78,[-0.00350467 -0.15833307 -0.04388865  0.02601446 -0.43787575  0.08729239],-2.3857767866714883
MGRO.JK,936,233,0.5965665236051502,331,605,[ 0.19701557  0.08771162 -0.02752025 -0.01251562  0.00920231  1.17524299],-0.6100952119224147
MICE.JK,966,241,0.5726141078838174,335,631,"[-1.52372671e-01 -5.75993288e-04  6.03930337e-02 -1.87576280e-02
  1.80472961e-02 -1.84690234e+00]",-0.6305616705678863
MIDI.JK,942,235,0.6042553191489362,186,756,"[-1.80257756e-01  2.07583427e-03  4.16722120e-03 -8.93667377e-02
  4.34856574e-04 -9.38605151e-01]",-1.399500499066558
MIKA.JK,966,241,0.5684647302904564,434,532,[-0.06740276 -0.00353895 -0.01265561 -0.07073654  0.01384907 -0.66080859],-0.2038923493115355
MINA.JK,644,161,0.7950310559006211,194,450,[ 0.57742328 -0.07817933 -0.05802642 -0.01188877  0.00283702 -0.09484171],-0.8432314546014368
MITI.JK,545,136,0.5882352941176471,134,411,[-0.08868703  0.02389614 -0.09929761  0.07589616  0.00171493 -0.51067601],-1.1289675966483768
MKNT.JK,301,75,0.8933333333333333,95,206,"[-9.81905233e-02  9.78066822e-02  1.27186823e-01 -4.57563721e-02
 -1.36092093e-03 -1.55772209e+00]",-0.7761162435460085
MKPI.JK,826,206,0.6504854368932039,87,739,"[ 5.56668143e-12 -2.73962439e-11  6.33509380e-10 -1.28677938e-09
 -1.47802666e-08 -4.73135799e-07]",-2.22535044654235e-08
MKTR.JK,75,18,0.6111111111111112,30,45,[ 0.00140116  0.03838114  0.03028572  0.24069746 -0.00527799  0.1188523 ],-0.4250279888620979
MLBI.JK,966,241,0.6265560165975104,281,685,[ 0.10038479 -0.00597874  0.01127872 -0.00579295  0.04499514 -0.28535675],-0.8908856395642858
MLIA.JK,967,241,0.6348547717842323,391,576,[ 0.00658079  0.00178335  0.0034997  -0.09015035  0.00528894  0.53276794],-0.39489315898892896
MLPL.JK,966,241,0.6473029045643154,291,675,[ 0.08166875 -0.01485528  0.01134628 -0.02204022 -0.00887392 -0.66234071],-0.8372611923685696
MLPT.JK,959,239,0.6234309623430963,315,644,[ 0.10570621 -0.02935044 -0.02735615  0.02505633 -0.00455356 -0.09878361],-0.715102274007945
MMIX.JK,59,14,0.5,24,35,[ 0.056307   -0.74095594  0.23489699  0.22977491 -0.05671017  0.29541667],-0.3568379492978696
MMLP.JK,965,241,0.6182572614107884,342,623,[-0.2209186  -0.00396894 -0.0162731   0.03242854 -0.00373808 -1.27670302],-0.5972954236008455
MNCN.JK,966,241,0.6390041493775933,358,608,"[ 7.18678084e-03 -8.78544180e-05 -5.52322169e-03  1.60643576e-02
  5.93377952e-03 -5.14969356e-01]",-0.5236989945211438
MOLI.JK,908,226,0.6194690265486725,260,648,[-0.35713366  0.01510143 -0.05394891 -0.03162471  0.00232268 -0.91286507],-0.9060723751452797
MORA.JK,127,31,0.6451612903225806,40,87,[-0.02061867  0.08061059 -0.07254872  0.34017949 -0.00730069  0.43736415],-0.7085402028429298
MPMX.JK,946,236,0.6313559322033898,362,584,[-0.01039988 -0.02417583 -0.00773698  0.08219493 -0.00012526 -0.05781131],-0.48390879582741386
MPOW.JK,966,241,0.6804979253112033,333,633,[-0.10554213  0.03556107  0.10111163 -0.00816204  0.00332489 -1.19272084],-0.6443874134244902
MPPA.JK,967,241,0.6473029045643154,344,623,[ 0.17453814  0.02067308  0.0391363  -0.00239395 -0.00583703  0.51071727],-0.6002016951648821
MPRO.JK,884,220,0.7318181818181818,234,650,[-0.1439474   0.0448824  -0.00290687  0.08765634  0.04630644  0.03654869],-1.0213161172593248
MRAT.JK,966,241,0.6099585062240664,334,632,[-0.24203437  0.00994027 -0.01131154 -0.01532205  0.01600303 -1.73216435],-0.6348288466578553
MREI.JK,944,235,0.6212765957446809,207,737,[-0.53069519 -0.00780176 -0.03010104  0.01592951  0.00286643 -0.65930268],-1.2649080128831334
MSIN.JK,955,238,0.6932773109243697,344,611,[ 0.65957706  0.01080189  0.03842018 -0.0863532   0.00379214 -0.05221512],-0.5813707783310734
MSKY.JK,965,241,0.6639004149377593,276,689,"[-2.26276284e-01 -6.68298018e-02 -6.77432369e-03  7.89144293e-02
  8.23520271e-05 -1.36981046e+00]",-0.9166170459039928
MTDL.JK,967,241,0.6597510373443983,409,558,[-0.1706267  -0.02127046  0.02471078  0.00153867  0.00779017 -0.1218755 ],-0.31099811471642125
MTEL.JK,264,65,0.6615384615384615,93,171,[-0.01060196  0.03999658 -0.01074103  0.17896519  0.14611204  0.05346663],-0.6042395508303233
MTLA.JK,966,241,0.6390041493775933,291,675,"[-2.13460208e-01 -8.45758388e-03  1.99353848e-05  1.50874005e-02
 -1.66728955e-02 -1.82878781e+00]",-0.8401796079421305
MTMH.JK,182,45,0.6,55,127,[ 0.01103839 -0.02565693 -0.2739559  -0.19788554  0.01244059  0.45271215],-0.8612795394233617
MTPS.JK,748,186,0.8387096774193549,235,513,[ 0.38439294  0.014272   -0.02048285  0.19044705  0.01462084  0.11456376],-0.7922501616665582
MTRA.JK,350,87,0.8045977011494253,95,255,[ 0.01133046  0.20042811 -0.11387021  0.01743587 -0.00397307 -0.03384587],-0.9995717078934907
MTSM.JK,965,241,0.6348547717842323,261,704,[-0.38079786  0.00986245 -0.01684306  0.0019165   0.01303895 -0.76929019],-0.98440064760597
MTWI.JK,965,241,0.6680497925311203,326,639,[-0.01730373 -0.02481466 -0.02042588  0.00468101 -0.00567067 -1.41478327],-0.6729645868205099
MYOH.JK,966,241,0.7427385892116183,354,612,[-0.10477569 -0.00835229 -0.01714089 -0.01916419  0.02457473 -0.96622714],-0.5495009365416634
MYOR.JK,967,241,0.5518672199170125,343,624,[-0.01184393 -0.02251681  0.00800916 -0.0190266   0.0007365   0.52436044],-0.6058975178162971
MYRX.JK,307,76,0.8421052631578947,91,216,[-0.03978854 -0.07121839 -0.03744221  0.36501368  0.00891083 -1.49118169],-0.9138796304977678
MYTX.JK,964,240,0.6708333333333333,275,689,"[-3.61623938e-01  9.54658415e-02 -4.37748215e-03 -6.43195186e-02
 -1.21308952e-03 -2.87928888e+00]",-0.932853405713461
NANO.JK,204,51,0.7647058823529411,47,157,[ 0.00934891  0.20811805 -0.02139966  0.56398507  0.13847545 -0.10669154],-1.2188056143266903
NASA.JK,576,143,0.7482517482517482,132,444,[ 0.15474791  0.01658285 -0.07903137  0.00459513  0.01678948  0.27086166],-1.2230415483297348
NASI.JK,252,62,0.7741935483870968,94,158,[-0.07063361  0.05790649 -0.09365943 -0.28141998  0.01687194  0.50776651],-0.5226106882863052
NATO.JK,827,206,0.6213592233009708,306,521,"[ 1.89376300e-01  1.71693516e-02  1.19738028e-03  1.03380544e-02
 -5.84915818e-03  1.49121321e+00]",-0.5537064017088134
NAYZ.JK,24,6,0.16666666666666666,14,10,[-0.02665071  0.35279049  0.4585425  -0.38173258  0.20209328  0.06137811],0.31274042644056527
NELY.JK,966,241,0.6680497925311203,336,630,"[-5.88615545e-02 -1.95486455e-04  1.99773816e-02  6.96286934e-02
 -1.83488450e-03 -1.41827170e+00]",-0.625636182018266
NETV.JK,227,56,0.6964285714285714,73,154,[-0.05619519 -0.01648986  0.53251999  0.01649381 -0.0064577  -1.06593857],-0.7349143022760254
NFCX.JK,936,233,0.6609442060085837,350,586,"[ 7.62358979e-01  5.21828718e-02  8.77224786e-03  2.92086565e-02
 -5.78909687e-04  9.01958777e-01]",-0.5218422064571113
NICK.JK,966,241,0.5394190871369294,312,654,"[-4.67112101e-01 -1.14803908e-03  2.01146997e-03 -2.27328093e-02
 -4.00695257e-03 -1.79340335e+00]",-0.7323300885376673
NICL.JK,337,84,0.5952380952380952,113,224,[ 0.08365856  0.00978771  0.11216103  0.00249123 -0.06989976 -1.24352297],-0.6883996594728995
NIKL.JK,966,241,0.6763485477178424,356,610,[ 0.17001321 -0.00824446 -0.21688668  0.0038281  -0.00899557  0.0752851 ],-0.5389111395236246
NINE.JK,60,14,0.8571428571428571,11,49,[-0.00834267  0.01654774  0.44467136  0.18410694 -0.06662427  0.80400039],-1.5441401016069527
NIRO.JK,964,241,0.7178423236514523,238,726,"[-7.57756590e-02  1.23452368e-02  3.08374861e-04 -2.40411324e-02
  6.22581653e-04 -2.54671555e+00]",-1.1218817004656156
NISP.JK,966,241,0.6099585062240664,309,657,"[-2.49793264e-02 -9.17298611e-02 -2.91740166e-02 -1.84867046e-02
  2.04585814e-04 -1.60708828e+00]",-0.7586669583627166
NOBU.JK,940,234,0.6581196581196581,240,700,[-0.29014685  0.03008248  0.00744889  0.04450321  0.00107027 -0.07902143],-1.0705279269692902
NPGF.JK,357,89,0.8539325842696629,107,250,[ 0.00560977  0.0810037  -0.00878629 -0.12718723  0.0370502   0.3030067 ],-0.8775876623669817
NRCA.JK,966,241,0.6058091286307054,366,600,[-0.08524699 -0.00263445  0.03321187 -0.00317797  0.01200346 -1.08863536],-0.48634745112561467
NSSS.JK,5,1,1.0,4,1,"[ 2.75939395e-05 -1.92862571e-01  7.07461396e-03  8.29812629e-02
 -7.26415025e-02 -2.29978569e-02]",1.3971623476753343
NTBK.JK,109,27,1.0,9,100,[-0.03849685  0.26069772 -0.14313817  0.06331727  0.03216801 -0.12150206],-2.4324015478926544
NUSA.JK,267,66,0.803030303030303,85,182,[ 0.33276511  0.22137517  0.65253756  0.37399987 -0.0045285   0.09767624],-0.7809668810797511
NZIA.JK,684,170,0.6294117647058823,239,445,[-0.00760496 -0.00144109  0.01263754  0.03697086 -0.00979461 -0.64592886],-0.6183283321017131
OASA.JK,966,241,0.5809128630705395,261,705,"[ 1.28031810e-01  7.16211804e-03  3.24452045e-03  1.00759165e-01
 -6.11639798e-05 -9.44578503e-01]",-0.9867254669512515
OBMD.JK,254,63,0.5396825396825397,95,159,[ 0.21698366 -0.08432831  0.4952668  -0.08436476 -0.11303584 -0.12361735],-0.562151746540793
OCAP.JK,324,81,0.9259259259259259,76,248,[-0.55796474  0.02306284  0.02428754  0.09021769 -0.07512774 -0.1547811 ],-1.162445446723985
OILS.JK,307,76,0.6447368421052632,101,206,[-0.08736839 -0.01823303 -0.14480419 -0.11293185 -0.01146389 -0.40429446],-0.7310049708618283
OKAS.JK,965,241,0.6639004149377593,321,644,[-0.22060301 -0.03256842  0.04708084 -0.03634345 -0.00468454 -0.17932254],-0.7109367282429131
OLIV.JK,172,43,0.7906976744186046,40,132,[-0.09073961 -0.04275259  0.13397797 -0.17771271 -0.05776082  0.58417106],-1.2382271745246909
OMED.JK,75,18,0.5555555555555556,27,48,[-0.01094047  0.13401241  0.42101729  0.43270021  0.13262034  0.08700588],-0.5772810009036151
OMRE.JK,689,172,0.6686046511627907,149,540,[ 0.01408992  0.00344334 -0.02089455 -0.00893821  0.00505515 -0.01749612],-1.2875702538348925
OPMS.JK,686,171,0.7485380116959064,258,428,[ 0.1834082  -0.11746138  0.11409707  0.1199017  -0.0119462   0.38333501],-0.5296113455911872
PACK.JK,23,5,0.4,11,12,[-0.0136482  -0.48967064 -0.08077229 -0.16136471 -0.09942651 -0.07354705],-0.02694598301517677
PADA.JK,57,14,0.35714285714285715,18,39,[-0.04258957  0.47674058 -0.41976234  0.06330085 -0.1266805   0.36905829],-0.8156535566135662
PADI.JK,364,91,0.8791208791208791,119,245,[-0.0677815  -0.00824221  0.00132031 -0.11286009 -0.01287188 -0.42425391],-0.7240651075920236
PALM.JK,967,241,0.6431535269709544,348,619,"[-6.49815316e-02 -2.12707076e-05 -7.29757109e-03 -9.90417341e-03
 -1.06778231e-02 -1.43851869e+00]",-0.5718193841427404
PAMG.JK,732,182,0.7307692307692307,249,483,[ 0.15136891  0.00171173 -0.00132573  0.02657302  0.01499766 -0.75190521],-0.6579662620600158
PANI.JK,896,224,0.6026785714285714,319,577,"[ 2.94631857e-02  5.24623310e-03 -7.47633932e-03 -7.69793598e-03
  8.22701545e-04 -1.63188060e+00]",-0.5916836903076323
PANR.JK,966,241,0.5767634854771784,358,608,[ 0.36103888  0.00277253  0.0261356   0.09912077  0.00055247 -0.19907709],-0.5317876376845074
PANS.JK,966,241,0.5601659751037344,372,594,"[ 2.55747160e-03  6.45260414e-02  1.09976130e-02 -9.63168222e-02
 -3.60517903e-04 -1.21970519e+00]",-0.4637335788327375
PBID.JK,966,241,0.6141078838174274,384,582,[-0.01747568 -0.05564807 -0.02057951 -0.0305554  -0.03138963 -2.21122447],-0.41716870952362917
PBRX.JK,966,241,0.7053941908713693,315,651,[-0.00555409 -0.00754301 -0.00908284  0.03355829 -0.00400094 -0.07756754],-0.7207072940683021
PBSA.JK,928,232,0.603448275862069,263,665,[-0.13350023 -0.0520238  -0.06299497 -0.07824321 -0.02176176 -0.05676329],-0.9326897123081404
PCAR.JK,955,238,0.7689075630252101,273,682,[-0.04607572  0.03925976  0.01866958  0.0416749  -0.01282834 -0.03476859],-0.9146577991916358
PDES.JK,860,215,0.7767441860465116,198,662,[-0.13249032  0.00077197 -0.0967648  -0.01489288  0.00112251  0.00016037],-1.2233965170765957
PDPP.JK,74,18,0.5,31,43,[-0.03911765  0.13013405 -0.22498869  0.04813589  0.02591913 -0.06875886],-0.40900769162952444
PEGE.JK,966,241,0.6514522821576764,292,674,[ 0.37566194 -0.0171445  -0.00368502 -0.04357294  0.04826381 -0.89952155],-0.8291221578439107
PEHA.JK,840,209,0.7129186602870813,299,541,[-0.14247357 -0.01532594  0.02430022  0.01077286 -0.00509991 -1.14440404],-0.5954241823853129
PEVE.JK,32,7,0.5714285714285714,12,20,[-0.02234819 -0.16241909  1.00526284  0.16026941  0.05684463 -0.31985005],-0.4384680408813482
PGAS.JK,966,241,0.5767634854771784,424,542,[-0.02008519  0.05478304 -0.0178158   0.03914855 -0.00536797 -0.35372381],-0.2430894465663829
PGEO.JK,13,3,0.6666666666666666,7,6,[-0.00320488 -0.38491731  0.17852748 -0.19035437 -0.12790033 -0.16866816],0.0862750169605501
PGJO.JK,622,155,0.7032258064516129,212,410,[ 0.26705397  0.0151556   0.23801796  0.02162625 -0.00197338 -0.23644389],-0.6722793514700102
PGLI.JK,963,240,0.6416666666666667,276,687,"[-2.19464799e-01  5.71312745e-04 -4.47529552e-03 -3.66337291e-02
  2.89675180e-03 -1.44033744e+00]",-0.9077581941443416
PGUN.JK,531,132,0.6439393939393939,169,362,[-0.13219422 -0.00385465 -0.0604965   0.00250485  0.02422152 -1.04805896],-0.7543924160005467
PICO.JK,966,241,0.6265560165975104,315,651,"[-2.31604319e-02  2.77616874e-04 -2.27201484e-02 -2.79070082e-02
 -4.07853923e-03 -1.76067970e+00]",-0.7271272430293818
PJAA.JK,965,241,0.6680497925311203,286,679,[-0.00392032  0.0013113  -0.03188833  0.00562204  0.0160846  -0.04174568],-0.8601815471184734
PKPK.JK,904,225,0.5333333333333333,254,650,"[-3.33178763e-02  1.06651665e-03 -1.22013409e-02 -1.06771414e-02
  4.03834903e-03 -1.22073677e+00]",-0.9435285773752069
PLAN.JK,494,123,0.7967479674796748,137,357,"[-2.93523395e-04  3.30022372e-02  4.17618637e-02 -3.45568807e-03
 -6.45059138e-03 -6.22613753e-01]",-0.9671734888405694
PLIN.JK,796,198,0.6767676767676768,151,645,[-0.3070845   0.00998585 -0.00413843  0.06713022  0.02857177  0.18754305],-1.4698383953048804
PMJS.JK,637,159,0.6352201257861635,223,414,"[-1.27770630e-01 -1.04820657e-03  1.59485235e-02 -1.64011747e-03
  5.49582207e-03 -1.95240225e+00]",-0.6199977494909492
PMMP.JK,444,110,0.7272727272727273,184,260,"[-8.98131211e-02 -3.33423433e-02 -1.53379287e-02 -8.82190123e-02
 -5.25254570e-04 -1.09544133e+00]",-0.35039723649144117
PNBN.JK,966,241,0.5767634854771784,370,596,[-0.01408272 -0.01759803 -0.01377449  0.01222081  0.00238361 -0.08846022],-0.48156956767619247
PNBS.JK,774,193,0.6735751295336787,233,541,[-0.02976372  0.13385929  0.0966847  -0.16104793  0.00361821 -0.83479718],-0.8498654955582995
PNGO.JK,504,125,0.688,169,335,[-0.14122466 -0.04785331 -0.0087267  -0.0139672  -0.01154784 -1.8565861 ],-0.6899314805950842
PNIN.JK,965,241,0.5850622406639004,356,609,[-0.10110648  0.05626956  0.03017264 -0.04185029 -0.0075847  -2.03700128],-0.5418013892266111
PNLF.JK,967,241,0.5933609958506224,355,612,[-0.00932662  0.00572277  0.00433221  0.02531515  0.00054803 -0.25822676],-0.5383022611230973
PNSE.JK,908,227,0.8414096916299559,146,762,[ 0.05582623 -0.02315188  0.1260037   0.0541955  -0.01341182 -0.02172393],-1.6692354498854454
POLA.JK,863,215,0.7255813953488373,238,625,[ 0.03971187  0.08658301  0.00457344 -0.00266764 -0.00559119 -1.10411824],-0.9630728325792749
POLI.JK,832,207,0.642512077294686,310,522,[-0.04559182  0.03409572  0.12520201 -0.07714536 -0.00970887 -1.91580937],-0.5318409070182886
POLL.JK,936,234,0.717948717948718,319,617,[ 0.62262829 -0.01294098  0.01508778 -0.01159907  0.02740197  0.43869843],-0.6660636975681989
POLU.JK,737,184,0.6467391304347826,213,524,"[-2.98670565e-01  1.88982818e-02  1.38066335e-04 -1.05563217e-01
 -8.24881131e-03  5.95176023e-02]",-0.9197382477682279
POLY.JK,864,216,0.7314814814814815,244,620,[-0.04343729 -0.00983356 -0.01225136  0.03186064  0.00580394 -1.68249418],-0.9354253223001169
POOL.JK,348,86,0.8604651162790697,138,210,[-0.08692844  0.00270749 -0.02531003  0.29206949  0.00927026 -0.04640675],-0.41955802834891304
PORT.JK,902,225,0.68,188,714,"[-5.05446046e-01 -1.81511003e-02 -1.82940916e-04 -3.58956999e-03
  1.69512699e-02 -6.65449171e-01]",-1.3339742503634167
POSA.JK,95,23,1.0,15,80,[ 0.12027785 -0.07990627  0.54389759  0.37509642 -0.53640795  0.57923641],-1.8134660151586552
POWR.JK,966,241,0.6721991701244814,293,673,[-0.00438406 -0.00334955  0.02781773  0.01530412 -0.00416549 -1.11836033],-0.8286265580795148
PPGL.JK,524,131,0.5801526717557252,184,340,[ 0.12171579  0.00934162 -0.00373431 -0.06476922  0.06943864  0.23675222],-0.6264550006961729
PPRE.JK,966,241,0.6721991701244814,341,625,[ 0.00019341  0.01337464  0.07131153 -0.04525521  0.00023135 -0.01091126],-0.606879616032129
PPRO.JK,831,207,0.8309178743961353,231,600,[ 0.00142634  0.15606805 -0.01056634  0.08252937  0.00436994 -0.02191909],-0.9476734665567855
PRAS.JK,965,241,0.7136929460580913,269,696,[-0.12510584  0.00854365 -0.00482039  0.0175877   0.00435406 -1.39239511],-0.9429947886463029
PRAY.JK,75,18,0.8333333333333334,28,47,[ 0.00159746 -0.00398044 -0.00542766 -0.06965337 -0.11496109 -0.40772255],-0.5528650381620513
PRDA.JK,966,241,0.6058091286307054,351,615,"[-5.29984801e-04 -2.21397938e-02 -3.17049811e-03  1.80878627e-02
  4.11571269e-03 -1.22607321e+00]",-0.5656239103719015
PRIM.JK,966,241,0.7178423236514523,302,664,[-0.00782294 -0.02292207  0.00291215 -0.00367198 -0.00477629 -0.66641833],-0.78322427164559
PSAB.JK,965,241,0.6141078838174274,347,618,[-0.08803118  0.01040835  0.19450294 -0.0016555  -0.0060032  -0.50449573],-0.5842112104037289
PSDN.JK,966,241,0.6514522821576764,311,655,[-0.25629865  0.01275887 -0.00175415 -0.04107657 -0.00895942 -1.1292314 ],-0.7441865618043554
PSGO.JK,651,162,0.6234567901234568,251,400,[-0.11241277  0.00635327  0.01348556 -0.02988051 -0.00755357 -0.75369858],-0.4719449541441221
PSKT.JK,265,66,0.7424242424242424,88,177,[-0.05143922  0.01042761 -0.11018919  0.76245279  0.01061521 -1.10837575],-0.732132596274166
PSSI.JK,966,241,0.6141078838174274,397,569,[-0.02027509 -0.00719255  0.02774388 -0.00821287  0.01265876 -0.68788538],-0.3451026118493858
PTBA.JK,966,241,0.5477178423236515,426,540,[ 0.00945203 -0.01889114 -0.05838313 -0.17874788  0.00536674 -0.5687794 ],-0.2321272275709733
PTDU.JK,420,104,0.7980769230769231,134,286,[ 0.48499819  0.31278928  0.05244264 -0.02810885  0.00932125  0.54019944],-0.7781216276709381
PTIS.JK,954,238,0.6470588235294118,211,743,[-0.01048987 -0.01248844 -0.011599    0.05672667  0.00744026 -0.96875115],-1.2582357574430034
PTMP.JK,8,2,1.0,2,6,[-0.00445273  0.26258598 -0.13613869 -0.03129623 -0.52008959 -0.0954652 ],-1.76268821370186
PTPP.JK,966,241,0.6141078838174274,384,582,[ 0.05902617 -0.00306583 -0.07291163  0.07976017  0.01120168  0.31938575],-0.41882304442099233
PTPW.JK,611,152,0.6447368421052632,227,384,[ 0.18459944 -0.02925629  0.01314633 -0.19917302  0.01920492  0.67757796],-0.545439985454446
PTRO.JK,966,241,0.5269709543568465,417,549,[-0.09621276  0.00290362 -0.01464014 -0.02845375 -0.0095635  -0.37533674],-0.2721070565546893
PTSN.JK,967,241,0.6473029045643154,341,626,"[-1.20774017e-02  1.11665895e-04 -8.45301013e-03 -4.02665735e-03
 -7.51393074e-03 -9.64960312e-01]",-0.6022312611650038
PTSP.JK,776,193,0.8393782383419689,145,631,[ 0.10480627  0.05882722  0.00725538  0.15277751 -0.02231261 -0.00717663],-1.4810582235334253
PUDP.JK,960,240,0.65,204,756,[-0.00109967  0.00037517 -0.13113627  0.31129476 -0.00197606 -0.06212508],-1.206421411139858
PURA.JK,404,100,0.87,150,254,[ 0.19969224 -0.06016235 -0.0348179   0.15552366 -0.00743278 -0.45324894],-0.550302351074257
PURE.JK,538,134,0.8283582089552238,167,371,[-0.09098787 -0.08868009 -0.04354542 -0.05314049  0.00234705 -0.40812147],-0.8042442064235958
PURI.JK,499,124,0.6532258064516129,166,333,"[-3.12127350e-01 -2.34854190e-02  2.93697311e-02  2.68620979e-01
  1.54148775e-03 -1.75390184e+00]",-0.7052217405170784
PWON.JK,965,241,0.6016597510373444,381,584,[-0.03388407 -0.00465535 -0.03325549  0.04212825  0.01285284 -0.17922389],-0.433602618666527
PYFA.JK,965,241,0.6721991701244814,286,679,"[ 2.20628077e-01  1.78538636e-02  2.90931251e-04  2.30399131e-02
  3.85914589e-04 -1.53306702e+00]",-0.8620926580855581
PZZA.JK,964,241,0.7593360995850622,348,616,[-0.05416512  0.06575439 -0.04696091 -0.02014023  0.00211013 -0.69575632],-0.5647392477346705
RAFI.JK,128,31,0.8064516129032258,45,83,[-0.04559279 -0.5004459   0.22091999 -0.433089    0.02014844 -0.31692383],-0.6465589017271167
RAJA.JK,966,241,0.5394190871369294,334,632,[ 0.00099468  0.01898264  0.00671036  0.03845896  0.00157193 -0.19992791],-0.6406774218570686
RALS.JK,967,241,0.6556016597510373,370,597,"[-3.08012247e-03 -6.75089461e-05 -8.67529958e-03 -3.72831277e-02
  3.75178113e-03  1.38800281e-01]",-0.481135166390376
RANC.JK,966,241,0.6763485477178424,306,660,[ 0.0535637   0.01771451 -0.0576958   0.10442504 -0.01478613 -0.34489998],-0.7660459069499561
RBMS.JK,768,192,0.7447916666666666,192,576,[-0.06527257  0.03970322  0.01725679 -0.02593358 -0.00488794 -0.35639325],-1.1104404147074185
RCCC.JK,130,32,0.40625,50,80,"[ 5.31614594e-05 -8.05889313e-02 -2.83102523e-03 -4.20256195e-02
  5.95516294e-03 -2.57364060e-01]",-0.44649203998180964
RDTX.JK,967,241,0.7344398340248963,171,796,[-0.10596019  0.02706161 -0.00942832  0.03547052 -0.01037947 -0.75210424],-1.5417326910281897
REAL.JK,284,70,0.7857142857142857,75,209,[-0.11347163 -0.06576643 -0.12733108  0.26700103 -0.01384582 -0.41614042],-1.061857527828413
RELI.JK,964,241,0.7136929460580913,186,778,[-0.48306297  0.00515017  0.02509924 -0.02128936 -0.00320923 -0.59244425],-1.4275913776438875
RICY.JK,965,241,0.6473029045643154,312,653,"[-7.16535363e-02  6.18743464e-03 -2.02786862e-02 -1.00982936e-01
  7.72380768e-04 -2.32055835e+00]",-0.7361813282363214
RIGS.JK,965,241,0.6390041493775933,354,611,[-0.0116991  -0.00904718 -0.01874003 -0.06400593 -0.01576185 -1.14526706],-0.5421486822040048
RIMO.JK,308,76,0.8026315789473685,114,194,[-0.01141122 -0.02563     0.00566167 -0.01003345 -0.0150813  -1.04150326],-0.5370904988780502
RISE.JK,938,234,0.7051282051282052,317,621,[ 0.2063076  -0.01372363  0.06495319 -0.02698567  0.00283783  0.76351898],-0.6771059368741457
RMBA.JK,637,159,0.710691823899371,194,443,"[ 1.50457346e-01 -7.42529253e-04  3.11741675e-02  3.01108433e-02
  6.85250253e-04 -1.74435580e+00]",-0.8262879220210154
RMKE.JK,255,63,0.6031746031746031,109,146,[-0.10050866  0.02743207  0.62783849 -0.08489349 -0.04317245  0.53241276],-0.31163822589741935
ROCK.JK,496,124,0.717741935483871,157,339,"[-3.36389004e-01 -1.08068883e-04 -1.04373511e-01 -1.60748377e-02
 -2.64596275e-03 -1.66712854e+00]",-0.762322394152513
RODA.JK,955,238,0.7521008403361344,274,681,[-0.03864607  0.00539639 -0.03470835 -0.01315271 -0.01448351 -1.79957208],-0.921024021188538
RONY.JK,326,81,0.7037037037037037,103,223,[-0.01685109  0.02706879 -0.01856587  0.24142907 -0.00922599 -0.80437062],-0.7843800951411837
ROTI.JK,966,241,0.6431535269709544,289,677,[ 0.00562997  0.00544328  0.1369129   0.00824476 -0.00423937  0.0099145 ],-0.8508432516001077
RSGK.JK,305,76,0.631578947368421,111,194,[-0.05117604 -0.01817387  0.08837094 -0.28399194  0.02401384 -0.74266777],-0.5437879440032919
RUIS.JK,967,241,0.6224066390041494,289,678,[-0.12859609 -0.05210224 -0.0510457  -0.06103609  0.04354114 -1.28549661],-0.8503433573763143
RUNS.JK,305,76,0.5789473684210527,111,194,[ 0.03449875 -0.12547185 -0.04462    -0.2155675  -0.00712775 -0.61859516],-0.5533812332704897
SAFE.JK,967,241,0.7136929460580913,306,661,"[-5.10660374e-01 -1.90679638e-02  9.36188552e-03 -2.94428029e-02
  6.07537888e-04 -1.72044134e+00]",-0.7651467944130839
SAME.JK,964,241,0.6224066390041494,338,626,[ 0.09070887 -0.02786504  0.03252355 -0.02172985  0.00291615 -0.43962478],-0.6189249839225704
SAMF.JK,582,145,0.503448275862069,196,386,[ 0.11010961  0.02267402  0.00902978 -0.02776541 -0.02870745  0.80830001],-0.6861947319791921
SAPX.JK,851,212,0.6698113207547169,207,644,[-0.31798527  0.00233493 -0.02105133 -0.10256079  0.00847462 -0.00281431],-1.126976992051116
SATU.JK,791,197,0.8274111675126904,225,566,"[-9.93376957e-02  3.78485787e-03  1.75560119e-02  9.99439976e-04
 -5.28043970e-02 -1.22440143e+00]",-0.9352620592957552
SBAT.JK,249,62,0.9838709677419355,79,170,[ 0.41556553 -0.04655446  0.69040464  0.19412989 -0.01092426  0.52749548],-0.7662469956279959
SBMA.JK,305,76,0.6052631578947368,108,197,"[ 1.75011910e-01  2.10980182e-02  1.94417216e-04  2.07478853e-02
 -3.47895683e-02  6.66161011e-01]",-0.6053105997820721
SCCO.JK,966,241,0.6929460580912863,238,728,"[-1.31321751e-03  1.72396484e-05 -1.48613579e-03 -9.86749301e-03
  8.31899776e-03 -8.74183227e-02]",-1.1185148975874888
SCMA.JK,967,241,0.6390041493775933,390,577,[-0.07851657 -0.0059306  -0.02041621  0.09419486  0.00453233 -1.08932296],-0.3901271485553419
SCNP.JK,500,124,0.7016129032258065,157,343,[-0.07369393  0.01706884 -0.01443418 -0.16382363  0.00739665 -0.37511657],-0.7896723342208463
SDMU.JK,719,179,0.7039106145251397,144,575,[-0.02713971  0.05348389  0.22757167  0.04775436  0.01442097 -0.44352429],-1.3881300774744434
SDPC.JK,966,241,0.6265560165975104,329,637,"[-1.58860436e-03  6.19995670e-06  3.73951357e-03 -1.89332182e-01
  3.62771111e-03 -1.86067681e-02]",-0.6109714414705756
SDRA.JK,966,241,0.6680497925311203,226,740,"[-2.77738448e-03 -3.24875912e-06 -9.13384288e-03  1.18746464e-02
 -4.35347614e-03 -5.85980993e-02]",-1.1893759174618361
SEMA.JK,236,59,0.7457627118644068,84,152,[ 0.01382731  0.13672649 -0.03216295  0.08924511  0.03686073 -0.25874155],-0.602014910680337
SFAN.JK,740,184,0.6304347826086957,250,490,[ 0.0632927   0.05123872  0.00079225 -0.10589722 -0.02822966  0.02639038],-0.6723415992613878
SGER.JK,513,128,0.65625,233,280,"[ 2.93340694e-01  3.84500907e-01  5.80719922e-02  8.07155706e-02
 -1.95638267e-04  1.70832232e-01]",-0.1801783503784048
SGRO.JK,966,241,0.6680497925311203,317,649,[-0.03092899  0.08016607 -0.02708866 -0.00342173  0.02846744 -1.700667  ],-0.7279366931775514
SHID.JK,960,239,0.6694560669456067,211,749,[ 0.19585653  0.00293735  0.00795867  0.03787542 -0.00445683  0.09045288],-1.2676344090198832
SHIP.JK,966,241,0.5435684647302904,354,612,[-0.19120989  0.02094527 -0.00832713 -0.00990107  0.02219143 -0.19111553],-0.5437141136789273
SICO.JK,188,46,0.717391304347826,66,122,[-0.00524024  0.03942014  0.0394017  -0.02273657  0.02195499 -0.34271646],-0.6091378370907048
SIDO.JK,967,241,0.6141078838174274,374,593,[-0.05459346 -0.00048423  0.01765649 -0.01173449 -0.03420953 -0.1650245 ],-0.4558900125903422
SILO.JK,967,241,0.5684647302904564,412,555,[ 0.0765425   0.0135008  -0.03253307 -0.00239201 -0.00938615  0.22332102],-0.2976517959083793
SIMA.JK,306,76,0.7894736842105263,101,205,[ 0.37004186  0.14459101  0.00692664  0.58425445  0.08178252 -0.03162256],-0.7195930947330519
SIMP.JK,966,241,0.6887966804979253,367,599,[ 0.00308889 -0.06545429  0.06395586  0.00510984 -0.00762914 -0.18621213],-0.5034912124573182
SINI.JK,660,164,0.573170731707317,244,416,[-0.32463497 -0.01132077  0.00495289  0.00497476 -0.01639058 -1.82615496],-0.5339998614693777
SIPD.JK,967,241,0.7261410788381742,254,713,[-0.28454265 -0.00912677  0.00555457 -0.00100778 -0.00132922 -0.81021498],-1.0269622627678618
SKBM.JK,966,241,0.6099585062240664,260,706,"[-5.73683279e-01 -6.52266187e-04 -5.49128023e-03 -1.95871699e-02
  3.60579623e-03 -1.50120505e+00]",-0.9977977947026384
SKLT.JK,719,179,0.45251396648044695,185,534,"[-4.82034616e-09 -1.36806389e-03 -1.69282302e-08 -2.18324848e-07
  5.77607299e-07 -2.09233554e-07]",-1.5351638018091594e-06
SKRN.JK,884,221,0.5746606334841629,354,530,"[-3.67300708e-02  2.26032614e-02  5.53857910e-04  8.67568746e-02
  1.57175057e-03 -9.45209944e-01]",-0.40093306097601183
SKYB.JK,329,82,0.8048780487804879,88,241,[ 0.06231464 -0.01278564 -0.18537617 -0.02782954  0.0318081  -0.24385586],-1.0135452830267997
SLIS.JK,679,169,0.6863905325443787,275,404,[ 0.49867032  0.03596864 -0.01221975  0.05366223  0.03854057  1.45651013],-0.39178841321462404
SMAR.JK,931,232,0.49137931034482757,280,651,"[-7.91065313e-13 -5.12638198e-07 -5.80822330e-11  1.42028810e-10
  2.96713082e-09 -2.64012132e-11]",-7.902562900134876e-10
SMBR.JK,966,241,0.6307053941908713,332,634,[ 0.21031565  0.02397667 -0.14149899 -0.07499416  0.00171289 -0.398081  ],-0.6386283437100365
SMCB.JK,966,241,0.6929460580912863,318,648,[ 0.07268667 -0.0141044  -0.00442936 -0.00407724  0.00392913  0.10219919],-0.7224740166428588
SMDM.JK,966,241,0.6307053941908713,335,631,[-0.3200012   0.01612414  0.00655305  0.02459982 -0.00466648 -2.96715909],-0.6374655626300267
SMDR.JK,967,241,0.6473029045643154,382,585,[ 0.09921883 -0.01815906  0.00105778  0.01147575 -0.00087384 -0.33975836],-0.4244993852642488
SMGR.JK,966,241,0.5767634854771784,424,542,[ 0.00317545  0.06607636 -0.00960218 -0.00227854 -0.01017107 -0.49764887],-0.2460025791067695
SMKL.JK,728,182,0.554945054945055,270,458,[-0.1014011   0.03293433  0.01195716  0.10280479  0.01090145 -1.63432958],-0.5272825560193506
SMKM.JK,205,51,0.43137254901960786,101,104,[ 0.07642474  0.00043541  0.25659495  0.23928524 -0.08829469  0.24858003],-0.014992129877200533
SMMA.JK,954,238,0.9201680672268907,150,804,[-0.07078659  0.01912199  0.01352446  0.00360768 -0.01254769 -0.71008356],-1.6790948580332217
SMMT.JK,966,241,0.6390041493775933,362,604,"[-2.54537278e-02  5.22385798e-03 -2.27322482e-02 -7.45902704e-02
 -3.28910902e-04 -1.45236755e+00]",-0.5014613643823824
SMRA.JK,966,241,0.6182572614107884,383,583,[ 0.0001711  -0.03609281  0.02079775  0.00348727  0.01076351 -0.00179913],-0.4239319396002025
SMRU.JK,254,63,0.8888888888888888,83,171,[ 0.01881605 -0.04598256  0.0325385   0.03955976 -0.01528955  0.46639272],-0.7413741143469362
SMSM.JK,967,241,0.5726141078838174,424,543,[-0.0281407   0.00109445 -0.05202859  0.00817982 -0.02321497 -0.29208011],-0.24369117176317215
SNLK.JK,392,97,0.5360824742268041,183,209,[ 0.49544219  0.15725066  0.07868772 -0.16427565 -0.03725555  1.58924338],-0.12481620176123655
SOCI.JK,966,241,0.6058091286307054,355,611,"[-1.27408309e-01  6.47966426e-04 -3.36837599e-02  3.31577788e-02
 -2.97119116e-03 -1.16684015e+00]",-0.5386280235665512
SOFA.JK,531,132,0.8787878787878788,154,377,"[ 3.52578090e-01 -8.55705770e-02  1.47038724e-01  3.74707874e-01
  6.50412487e-06 -1.15422905e+00]",-0.892781988073685
SOHO.JK,498,124,0.7903225806451613,166,332,"[-9.33323157e-02 -5.86696124e-02 -2.70978303e-02  1.42613674e-01
  8.64253207e-04 -1.32375129e+00]",-0.6895022871340631
SONA.JK,762,190,0.9736842105263158,68,694,[ 0.3655641  -0.03401263  0.01535044 -0.01587482 -0.00284698 -0.04575624],-2.316563829315866
SOSS.JK,869,217,0.5299539170506913,340,529,"[-2.40951412e-01 -8.15088048e-03  1.36633176e-03 -4.10291356e-02
 -2.52245850e-03 -1.60785341e+00]",-0.43896630186598073
SOTS.JK,848,211,0.6966824644549763,278,570,"[-2.21358072e-01  2.44408438e-02  2.45234745e-02 -2.65703648e-02
  9.75586166e-04 -2.07052521e+00]",-0.7174589540169329
SOUL.JK,40,10,0.8,9,31,[-0.00904213  0.37732536  0.05746274  0.0868267   0.46475036  0.4315765 ],-1.1922572518541668
SPMA.JK,967,241,0.6307053941908713,372,595,[-0.17681382  0.02171428 -0.02481629  0.12755435 -0.00608223 -1.387545  ],-0.4656740764809125
SPTO.JK,966,241,0.7385892116182573,322,644,"[ 2.20442384e-04 -1.26897653e-02 -5.78627735e-02 -2.36123500e-02
 -5.18131705e-03 -9.51444066e-01]",-0.6814515856439023
SQMI.JK,966,241,0.6970954356846473,297,669,[ 0.27953472 -0.05595301 -0.00075564  0.01385116  0.00238514 -0.08410376],-0.8069211930972409
SRAJ.JK,967,241,0.6348547717842323,336,631,[-0.54620352 -0.00332622 -0.01454002 -0.00390336 -0.00153371 -1.39090394],-0.6271507196131708
SRIL.JK,593,148,0.7094594594594594,213,380,[-0.14069901  0.02247085 -0.00660643  0.02671485 -0.00809619 -0.27079575],-0.5790802160712817
SRSN.JK,945,236,0.8008474576271186,272,673,"[-1.87465247e-01 -2.40252567e-03 -1.04031022e-02  4.58710784e-02
  8.17862285e-05 -2.02037054e+00]",-0.9052281781515946
SRTG.JK,967,241,0.6099585062240664,377,590,"[-3.92096912e-02  1.87983432e-03  8.40887626e-04 -8.80390534e-03
 -2.96040866e-03 -1.63024205e+00]",-0.4465289033177992
SSIA.JK,966,241,0.5809128630705395,353,613,[-0.00666285 -0.01006828  0.00660845  0.02893011 -0.0010144  -0.73579452],-0.5488240245133169
SSMS.JK,966,241,0.5103734439834025,366,600,"[-1.23502584e-04  2.42435309e-06  1.28091591e-01  2.58230938e-01
 -1.62941554e-03 -1.87918121e-02]",-0.3535752580425268
SSTM.JK,954,238,0.7815126050420168,260,694,[-0.34916904 -0.00077779 -0.06903948 -0.01591117 -0.00057143  0.0785081 ],-0.9927850305995243
STAA.JK,204,51,0.6666666666666666,85,119,[ 0.02963994 -0.16999955  0.12098208 -0.72762232 -0.02866994 -0.92729794],-0.3484605542432202
STAR.JK,965,241,0.7302904564315352,294,671,"[-1.89536797e-02 -9.75663935e-03 -1.32113372e-03  1.45791256e-02
  3.03554580e-03 -2.44670543e+00]",-0.827074171887879
STTP.JK,750,187,0.732620320855615,159,591,[-0.00132241  0.00965696  0.0443713  -0.0101463   0.01630824  0.00504877],-1.3155901544518591
SULI.JK,593,148,0.6216216216216216,153,440,[ 0.27598364  0.05456528 -0.01354116 -0.20793012  0.00947151  0.1688449 ],-1.0692941685433834
SUNI.JK,40,9,0.6666666666666666,17,23,[-0.00621215  0.2148523   0.33231612  0.48064772 -0.21390777  0.36591701],-0.4717105530482506
SUPR.JK,630,157,0.9681528662420382,80,550,[ 0.60305813  0.06388513 -0.0187508  -0.00168205 -0.00356383  0.0219573 ],-1.9433592830294004
SURE.JK,863,215,0.9348837209302325,165,698,[-0.16860388 -0.01078987 -0.02932173 -0.00135677 -0.00212332 -1.09004083],-1.4364114387499953
SWAT.JK,912,227,0.7533039647577092,303,609,[-0.33866028 -0.0199026   0.04481146  0.01512056  0.01158945 -0.70276296],-0.7018440585431608
SWID.JK,144,36,0.6666666666666666,38,106,[-0.02875665 -0.31784951  0.15052687  0.23134899  0.09146688 -0.8627917 ],-1.0144074813003798
TALF.JK,963,240,0.7041666666666667,252,711,"[-5.35619305e-01  3.68828424e-04  3.34622755e-02 -1.28493444e-02
 -3.88925337e-03 -1.47999930e+00]",-1.040241794113164
TAMA.JK,472,117,0.8888888888888888,151,321,[-0.08073324 -0.06538715  0.05667365 -0.02342955  0.01241246 -0.07544055],-0.7661353641868488
TAMU.JK,495,123,0.7886178861788617,231,264,[0.15162673 0.26389175 0.0172273  0.0074098  0.00534612 0.10858739],-0.13085904398479742
TAPG.JK,384,96,0.6770833333333334,157,227,[-0.1138039  -0.17340864 -0.13426821 -0.00399335 -0.00649147 -0.25498435],-0.41225256575998276
TARA.JK,396,98,0.9795918367346939,156,240,[ 0.13762683  0.04858982 -0.066297   -0.00787061 -0.02847672 -1.61109567],-0.42691688410239204
TAYS.JK,256,63,0.7619047619047619,93,163,[ 0.02915441 -0.06176007  0.02403257  0.20841431 -0.01475565  0.32274587],-0.5799153277954265
TBIG.JK,967,241,0.5809128630705395,425,542,[-0.00914108  0.00408888 -0.005415    0.12409325  0.01398036 -0.72249859],-0.24627886876858093
TBLA.JK,966,241,0.7095435684647303,387,579,[-0.00088298 -0.00399588  0.01519146  0.13390794  0.00519274 -0.00409464],-0.4032694286547511
TBMS.JK,966,241,0.7178423236514523,252,714,"[-1.83772782e-03  2.63648332e-06  1.08862029e-03 -2.21150696e-02
  8.41180034e-03 -4.67760340e-02]",-1.050552315456854
TCID.JK,947,236,0.6186440677966102,192,755,[-0.10588739  0.00141641 -0.01862916  0.05708379 -0.00496421 -0.59934082],-1.366557772503037
TCPI.JK,892,223,0.5336322869955157,423,469,[-0.05433812 -0.01734165  0.09200119  0.03903775  0.02920057 -0.04633461],-0.10977050810826652
TDPM.JK,584,145,0.6620689655172414,196,388,[-0.11866828  0.01797049  0.01232391  0.04284127  0.01609758 -0.12225616],-0.6727993658690157
TEBE.JK,643,160,0.59375,187,456,[-0.10532503  0.01056816  0.02117499  0.04257765 -0.02229315 -0.33232547],-0.8877180174198718
TECH.JK,499,124,0.7661290322580645,218,281,"[ 3.23946957e-02 -2.85993526e-02 -2.07030055e-02  1.31171098e-03
 -4.21218259e-02  1.37397733e+00]",-0.2708011201273273
TELE.JK,421,105,0.7428571428571429,121,300,[-0.14233591  0.02348012  0.01263517 -0.29249637  0.02325421 -0.55129875],-0.898228433749833
TFAS.JK,672,167,0.6047904191616766,250,422,[ 0.35845163 -0.00910866  0.10856544 -0.00486053  0.05444325  0.29359358],-0.520532416575669
TFCO.JK,955,238,0.9033613445378151,229,726,[-0.0169715   0.00590366  0.00946025 -0.04670708 -0.00084905 -0.21411091],-1.1527861991009145
TGKA.JK,960,239,0.702928870292887,214,746,[-0.18500953 -0.02210026  0.07421207  0.00608534 -0.02386791 -0.61931922],-1.2714943451910221
TGRA.JK,916,229,0.7991266375545851,294,622,[ 0.01661547  0.00329065 -0.00344266 -0.00897065 -0.00249674 -0.28352333],-0.7446892823318653
TIFA.JK,966,241,0.7261410788381742,322,644,"[ 5.25115330e-04  2.59800939e-03  1.52564734e-03  3.65820245e-03
 -3.73117188e-02 -5.71519785e-01]",-0.6921417492997036
TINS.JK,965,241,0.6058091286307054,393,572,[-0.07577134  0.0153806  -0.09677869 -0.04436221  0.01679042 -0.51143942],-0.3758591843268623
TIRA.JK,964,241,0.6431535269709544,301,663,[-0.44503893  0.00803974 -0.00336506  0.02630658 -0.03125642 -1.70575279],-0.7920042554817107
TIRT.JK,896,223,0.7802690582959642,241,655,[-0.17652734  0.01286808  0.03204288 -0.05163455 -0.00457706 -3.06375061],-1.018826456911298
TKIM.JK,966,241,0.6141078838174274,399,567,[-0.13219896 -0.00482789  0.05029437  0.00092377  0.04979545  0.41506084],-0.35543849109210335
TLDN.JK,186,46,0.6521739130434783,39,147,[-0.01500166  0.00384408 -0.15247769 -0.28733228  0.00610945 -0.88522114],-1.3216824140028602
TLKM.JK,966,241,0.5518672199170125,415,551,[-0.03368271  0.01561642  0.01593293 -0.02586078 -0.00135007 -0.61075977],-0.28635317672316296
TMAS.JK,967,241,0.5352697095435685,317,650,[ 0.16291747  0.04357247  0.04638783  0.04513049 -0.00432527 -0.75391279],-0.7053380002683786
TMPO.JK,964,241,0.6763485477178424,296,668,[-0.37626227  0.10103733  0.01121802  0.00475471  0.00468267 -2.25705334],-0.8148890636899869
TNCA.JK,943,235,0.6638297872340425,341,602,"[-2.37307493e-02  4.29830106e-03 -1.25912396e-04  1.07242984e-01
  3.92141357e-04 -7.47836273e-01]",-0.5648164511383114
TOBA.JK,966,241,0.6556016597510373,257,709,"[-1.93637874e-03  5.91995686e-03  7.08946492e-03  1.15129950e-01
 -6.61266484e-04 -7.82563490e-01]",-1.0107190441486418
TOOL.JK,125,31,0.6774193548387096,25,100,"[-2.85863205e-02  6.07229823e-02 -1.30636946e-01  4.84058709e-01
  1.39922093e-03  1.65239052e+00]",-1.4005986995645636
TOPS.JK,407,101,0.9306930693069307,129,278,[-0.04479554 -0.04753869 -0.05178721  0.07429598  0.0149007  -0.24258259],-0.7573637471056168
TOTL.JK,966,241,0.6265560165975104,309,657,"[ 9.36062496e-05  1.51502293e-04  1.14248570e-04 -3.60307398e-02
 -1.07314230e-01 -6.14638694e-03]",-0.35336659124119707
TOTO.JK,966,241,0.6887966804979253,304,662,[-0.02252363  0.01409853 -0.0074973   0.00419708  0.02451094 -2.53871927],-0.7838047813647497
TOWR.JK,966,241,0.5892116182572614,367,599,[-0.02345389  0.00425786 -0.01236726 -0.01018243  0.0176778  -1.10130352],-0.4843376983402498
TOYS.JK,514,128,0.7265625,165,349,[ 0.14371434  0.15732504 -0.12575972  0.43508402 -0.04695712 -0.5405087 ],-0.7700874111185299
TPIA.JK,967,241,0.6016597510373444,464,503,[ 0.46642743  0.04039461 -0.0310874  -0.26178685 -0.01421137  0.62490089],-0.10291611096449363
TPMA.JK,966,241,0.5809128630705395,281,685,"[-2.94876670e-04 -1.24391092e-04 -2.16628273e-01  2.04649982e-02
 -8.35589354e-03 -2.09638089e-02]",-0.4959661309391672
TRAM.JK,323,80,0.8,106,217,[-0.09147148  0.00654301 -0.0694125   0.10746307  0.06382096 -1.20755712],-0.7200312543126931
TRGU.JK,144,35,0.7142857142857143,38,106,[-0.02993456 -0.01689598 -0.02929522  0.72680733  0.01102274 -0.87137233],-0.9934806961521694
TRIM.JK,964,240,0.6208333333333333,304,660,[-0.06651437 -0.01061043 -0.00729634 -0.10308483  0.02993981 -3.01205619],-0.7957770534147822
TRIN.JK,624,155,0.6387096774193548,237,387,[ 0.04723696  0.10731896  0.05994615  0.10025541 -0.01199427 -0.01343151],-0.4962184863810931
TRIS.JK,967,241,0.6141078838174274,300,667,[-0.3768172   0.01535638 -0.00342288  0.02434047  0.00748036 -0.89706711],-0.793530480710126
TRJA.JK,505,126,0.6111111111111112,212,293,[-0.03220155  0.01104766  0.07530127 -0.11791436  0.01181736  0.30612927],-0.3359404803784634
TRON.JK,7,1,0.0,3,4,[ 0.00066671  0.07819526 -0.03273165  0.47487207 -0.25231034  0.13468104],-0.43346613295447817
TRST.JK,929,232,0.7370689655172413,160,769,"[-1.50838446e-02 -8.07727497e-02  1.04194833e-01  1.46017536e-02
  1.60989115e-04 -2.07175253e+00]",-1.6032526726802192
TRUE.JK,304,75,0.9066666666666666,81,223,[ 0.00744598  0.07082591  0.12754169 -0.47144282  0.09100283 -0.02002527],-1.0324431408237393
TRUK.JK,963,240,0.65,327,636,[-0.03794007 -0.036288   -0.0111942  -0.04049668  0.01062515 -0.2520734 ],-0.6612640835394922
TRUS.JK,967,241,0.6182572614107884,275,692,[-0.50963153 -0.00543383 -0.00104666  0.02276774 -0.00275281 -0.67592813],-0.9162896712655892
TSPC.JK,967,241,0.6721991701244814,344,623,"[ 7.17923429e-03  6.03860245e-05  1.06316659e-02 -1.53204734e-03
 -3.30235666e-03 -2.79803440e-01]",-0.5903689454324966
TUGU.JK,961,240,0.5875,293,668,[-0.175459   -0.11306775  0.05064285  0.03266639  0.00691762  0.10250322],-0.8316119737803743
UANG.JK,532,133,0.631578947368421,168,364,[-0.06464742  0.04026531 -0.02360706  0.00125534 -0.09303671 -0.76362093],-0.7789251130995237
UCID.JK,636,158,0.6708860759493671,225,411,[-0.0093915  -0.00241368  0.00162537 -0.08569979 -0.00930894 -0.2118537 ],-0.6021914213226272
UFOE.JK,422,105,0.580952380952381,174,248,[ 0.19174451  0.09925428 -0.03375565 -0.02490581  0.01108899  1.81666854],-0.37537195630055237
ULTJ.JK,966,241,0.6099585062240664,351,615,"[-2.16049323e-02 -9.87476396e-05  1.02202855e-02  1.06227337e-01
 -6.20473118e-03 -7.40720058e-01]",-0.5556161747270525
UNIC.JK,965,241,0.6639004149377593,313,652,[-0.00345447 -0.00756445  0.01121402 -0.03406234  0.00112943 -0.81976122],-0.7337908131140852
UNIQ.JK,403,100,0.69,103,300,[-0.10687063  0.06239619 -0.02526341  0.25061713  0.00356109 -2.68943991],-1.0873438202551307
UNIT.JK,553,138,0.6594202898550725,165,388,[-0.27672923 -0.01470127 -0.01170574  0.13542138  0.00584976 -1.48528759],-0.8690161476819038
UNSP.JK,966,241,0.5892116182572614,369,597,[-0.01407449 -0.03564315  0.02049937 -0.01734349 -0.01348274 -0.87258012],-0.47973895441692366
UNTR.JK,966,241,0.5601659751037344,429,537,[-0.02051505  0.06542153 -0.0330287   0.00624092 -0.01005356 -1.00606141],-0.22072425109113472
UNVR.JK,967,241,0.5311203319502075,395,572,[-0.01025101  0.00517261  0.02034778 -0.01673685 -0.0007169  -0.49485968],-0.36886580860855633
URBN.JK,849,212,0.5943396226415094,187,662,[ 0.05801725 -0.04186151  0.00078775 -0.0382322   0.00438936 -0.00928005],-1.2706562394238052
UVCR.JK,328,82,0.6463414634146342,123,205,[-0.08340218  0.1954199  -0.04330871 -0.39783263  0.09523796  0.82453216],-0.5301039554946839
VAST.JK,23,5,0.6,5,18,[-0.00518677  0.1062226  -0.23497841 -0.28259383 -0.07077688 -0.22914507],-1.4071420988763852
VICI.JK,444,111,0.5945945945945946,160,284,[ 0.08862406 -0.03224052  0.03693359 -0.1534908   0.02251657  0.40735072],-0.5611714719747173
VICO.JK,965,241,0.6680497925311203,329,636,"[-2.55102642e-01 -4.13218894e-02 -1.75200048e-03 -2.06654654e-02
 -3.03869494e-03 -3.15780226e+00]",-0.6651363930582869
VINS.JK,966,241,0.6348547717842323,357,609,"[-2.51950606e-03  4.58207218e-06 -6.86684725e-03 -2.65239562e-03
 -4.26339454e-03 -2.97266758e-02]",-0.5278878273326705
VIVA.JK,538,134,0.8432835820895522,146,392,[ 0.00970242 -0.02471381  0.04772074 -0.06762405 -0.00808123  0.7237181 ],-0.9812152647636359
VOKS.JK,966,241,0.5560165975103735,363,603,[-0.21488396  0.03482245  0.04352916  0.05129218  0.00221523 -0.94427615],-0.5080402981850062
VRNA.JK,956,239,0.6401673640167364,250,706,[-0.43791002  0.07860813  0.03273095  0.02863885 -0.00169261 -0.16354591],-1.0436463664453723
VTNY.JK,53,13,0.5384615384615384,22,31,[-0.04085201  0.81452572 -0.40638279  0.29567753 -0.05339117 -0.12076872],-0.43987411580814295
WAPO.JK,965,241,0.6265560165975104,296,669,[-0.03669209 -0.02240415 -0.00433521 -0.00985398 -0.00352355 -2.06142471],-0.8176588143182968
WEGE.JK,966,241,0.6639004149377593,374,592,[-0.01708376  0.02501535 -0.0133284  -0.00697303 -0.00592566 -1.15278919],-0.45105101960707844
WEHA.JK,966,241,0.6431535269709544,296,670,[ 0.01423951 -0.0042154   0.05919408  0.02968905  0.00171751  0.45821298],-0.8285786142283628
WGSH.JK,256,63,0.6031746031746031,95,161,[-0.00583557  0.23671668  0.06551575  0.11032488 -0.00271649 -0.17163486],-0.5317367807861313
WICO.JK,965,241,0.7842323651452282,182,783,[-0.42918694  0.01325671  0.0184327  -0.00441457  0.02830832 -2.31866603],-1.4810126698721775
WIFI.JK,439,109,0.6238532110091743,153,286,[ 0.01483095  0.00649652 -0.06542903  0.04267388 -0.00346558  0.39221162],-0.6288082888162513
WIIM.JK,966,241,0.5643153526970954,328,638,[ 0.00815989 -0.07804952 -0.01076003 -0.00243556 -0.00062591  0.24663492],-0.6692979285256299
WIKA.JK,965,241,0.6514522821576764,397,568,[ 0.01160922  0.01928114  0.02094166 -0.00404265 -0.00211466 -0.3947495 ],-0.35340555949768293
WINE.JK,39,9,0.6666666666666666,15,24,[-0.01228355 -0.05516523  0.07525926  0.40438134  0.32046371  0.06138198],-0.5016735636317069
WINR.JK,67,16,1.0,7,60,[-0.02382262  0.00048015 -0.01230405  0.06778912  0.15779388  0.46596418],-2.149651234882836
WINS.JK,964,241,0.5601659751037344,310,654,"[-2.00978013e-01 -9.05868094e-04 -7.27103135e-03  2.24399687e-01
  1.42772391e-02 -2.09456307e+00]",-0.7511427636348977
WIRG.JK,191,47,0.6382978723404256,59,132,[ 0.03504317 -0.02473129  0.06581272  0.12036924  0.00328187 -0.62442179],-0.8011028442854817
WMPP.JK,256,63,0.8412698412698413,98,158,[ 0.0186674   0.0054952   0.00774257  0.07443511  0.01170329 -0.90846657],-0.4761531268211481
WMUU.JK,421,105,0.7904761904761904,141,280,[-0.06999356 -0.04884054 -0.10265061  0.02608137  0.08137625 -0.80785993],-0.6936458956052343
WOMF.JK,966,241,0.6141078838174274,343,623,"[-5.18963255e-02  1.34914349e-04  1.41374359e-03  1.92639071e-02
 -1.48556364e-02 -1.24690614e+00]",-0.5895537540260104
WOOD.JK,966,241,0.6390041493775933,352,614,[-0.04423287  0.04883682  0.00481952  0.01054053  0.03320515 -0.23063083],-0.556432650540258
WOWS.JK,424,105,0.8761904761904762,98,326,[ 0.02421592 -0.07190298  0.02799242 -0.00226313 -0.02088034 -1.29962198],-1.2160112999643053
WSBP.JK,761,190,0.7315789473684211,277,484,[-0.00946238  0.0051645  -0.00760488  0.02523666 -0.00641576 -0.35780293],-0.5595796376811939
WSKT.JK,965,241,0.7012448132780082,377,588,[ 0.11139409  0.04152483 -0.00277546  0.01106606  0.00195375  0.02077314],-0.4474851059253205
WTON.JK,966,241,0.6514522821576764,367,599,"[-1.27608504e-01  2.64455507e-05 -1.55368840e-02  3.89360716e-02
 -3.23263359e-02 -1.07080549e-01]",-0.4983076779961101
YELO.JK,778,194,0.7268041237113402,227,551,[ 0.1105915  -0.08284618 -0.10807328  0.08989747  0.01059899 -0.90656482],-0.8888390674255251
YPAS.JK,964,240,0.6375,251,713,[-0.355317   -0.0024843  -0.0153456   0.05201287 -0.00368772  0.43377975],-1.0584359053873327
YULE.JK,958,239,0.7824267782426778,247,711,[-0.07637265  0.04265998  0.00321792  0.02001516 -0.0063727  -1.29264555],-1.0556778803458915
ZATA.JK,73,18,0.8333333333333334,16,57,[ 0.01645136 -0.10852753  0.78474404 -0.10351819  0.16553031  0.78204903],-1.2134593355644916
ZBRA.JK,609,152,0.8092105263157895,157,452,[ 0.79190117  0.03982067 -0.01928731  0.14499264  0.04050358 -0.45977991],-1.0661988603697619
ZINC.JK,886,221,0.7375565610859729,334,552,[ 0.17756442 -0.01724282  0.04524725 -0.03098193 -0.00190031  0.07598004],-0.5061149232808668
ZONE.JK,848,211,0.5924170616113744,313,535,"[2.28764366e-01 5.61323815e-05 9.74032198e-02 3.23259059e-02
 3.48817563e-02 3.76467365e-01]",-0.5514958108943704
ZYRX.JK,391,97,0.7422680412371134,139,252,[ 0.04645999 -0.03282134  0.01128315  0.19320103 -0.02611392  0.57299316],-0.6032948846091848
