,Ticker,Training Data Size,Test Data Size,Accuracy,train_true,train_false,coef,intercept
0,AALI.JK,968,241,0.6058091286307054,425,543,[[-0.00782802  0.01299754  0.10159681 -0.00265748 -0.33254032]],[-0.24631402]
1,ABBA.JK,967,241,0.6639004149377593,249,718,[[ 0.58782357  0.0937154  -0.07444632  0.03943856 -0.26862868]],[-1.06729803]
2,ABMM.JK,967,241,0.5643153526970954,260,707,[[-0.30339467  0.02457919  0.00985933 -0.00102328 -0.72575081]],[-0.99524952]
3,ACES.JK,967,241,0.6099585062240664,424,543,[[-0.32693263  0.01917702  0.0023183   0.03526132  0.88164385]],[-0.25318943]
4,ACST.JK,967,241,0.5809128630705395,337,630,[[ 0.59911545  0.00672997 -0.06096878 -0.00864355 -0.20297277]],[-0.62224794]
5,ADCP.JK,209,52,0.8076923076923077,60,149,[[-0.0638015  -0.16939528 -0.02200406 -0.09731478 -1.03202873]],[-0.89131374]
6,ADES.JK,967,241,0.5601659751037344,384,583,[[-0.02330494  0.01134937 -0.05753992  0.00162454 -0.58187431]],[-0.42025269]
7,ADHI.JK,967,241,0.6431535269709544,377,590,[[ 0.15773291  0.02010566 -0.06481099  0.00418591  0.88017101]],[-0.45611319]
8,ADMF.JK,967,241,0.5933609958506224,387,580,[[ 0.0009457  -0.01934012  0.01437721  0.00852573 -0.10069467]],[-0.40599208]
9,ADMG.JK,968,241,0.7136929460580913,354,614,[[ 0.06304645  0.01503072  0.01089805 -0.03082259 -0.41754398]],[-0.55285873]
10,ADMR.JK,238,59,0.7627118644067796,105,133,[[-0.02919318  0.01548492  0.05714227 -0.00519886 -0.03474415]],[-0.22857417]
11,ADRO.JK,967,241,0.5103734439834025,412,555,[[-0.10798574  0.00845153 -0.04195489 -0.03724061 -0.16825597]],[-0.30753826]
12,AGAR.JK,644,161,0.6273291925465838,183,461,[[-0.47535526  0.01834708  0.06165283  0.01971848 -2.08367674]],[-0.91435624]
13,AGII.JK,967,241,0.5601659751037344,374,593,[[ 0.24192798 -0.00356796 -0.00395875 -0.03751024 -0.58875409]],[-0.45560916]
14,AGRO.JK,967,241,0.6307053941908713,366,601,"[[-1.30309999e-07  1.08189086e-04 -1.52735163e-05  2.58223713e-05
   2.41728752e-06]]",[-0.000249]
15,AGRS.JK,967,241,0.6970954356846473,331,636,[[-0.11953723  0.11694725  0.04145335 -0.00656042 -1.13592483]],[-0.65182114]
16,AHAP.JK,968,241,0.6887966804979253,284,684,"[[-2.01098187e-01 -1.29858036e-02  3.96746189e-02  4.73300362e-04
  -1.77912083e+00]]",[-0.87809277]
17,AIMS.JK,968,241,0.6514522821576764,167,801,[[0. 0. 0. 0. 0.]],[0.]
18,AKKU.JK,967,241,1.0,5,962,[[0. 0. 0. 0. 0.]],[0.]
19,AKPI.JK,967,241,0.6473029045643154,255,712,"[[-3.89410164e-01  1.48627496e-02 -9.05922406e-03  1.04458337e-04
  -4.81226808e-01]]",[-1.02506587]
20,AKRA.JK,968,241,0.5601659751037344,408,560,[[-0.03472841 -0.06438272  0.06428464  0.0006297   0.34681114]],[-0.32376955]
21,AKSI.JK,967,241,0.6970954356846473,317,650,[[ 0.03333998 -0.00789422  0.00082197  0.01103649  0.28394664]],[-0.7256179]
22,ALDO.JK,967,241,0.6390041493775933,275,692,[[ 0.5442732  -0.02312481  0.02009499 -0.01287875 -0.81827567]],[-0.93482587]
23,ALKA.JK,967,241,0.6473029045643154,297,670,"[[-8.48233084e-01 -7.23152162e-04 -3.05341350e-03 -7.88282650e-03
  -9.33505140e-01]]",[-0.80999933]
24,ALMI.JK,968,241,0.6016597510373444,326,642,[[-0.56091374 -0.00759921  0.11471141  0.01419823 -2.02300313]],[-0.68515762]
25,ALTO.JK,967,241,0.8672199170124482,195,772,"[[-1.34716926e-01  2.62110469e-04  2.02838094e-02  3.46032603e-04
  -2.01188304e+00]]",[-1.38395256]
26,AMAG.JK,967,241,0.6224066390041494,255,712,[[-0.50024631 -0.00293168  0.02685206 -0.00537356 -0.46821164]],[-1.02898515]
27,AMAN.JK,588,147,0.782312925170068,167,421,[[ 0.31615193  0.00612244 -0.04799507 -0.0022174   0.25864747]],[-0.92954384]
28,AMAR.JK,625,156,0.532051282051282,228,397,[[-0.26350827 -0.03158944  0.13441386 -0.00642501 -0.29163463]],[-0.5547353]
29,AMFG.JK,968,241,0.5892116182572614,255,713,[[ 0.12244326  0.01325451 -0.00284617  0.00331244 -0.2307899 ]],[-1.02869554]
30,AMIN.JK,967,241,0.6556016597510373,266,701,[[-0.65651193 -0.01062339 -0.05062916 -0.00795242 -0.93966421]],[-0.97347343]
31,AMMS.JK,126,31,0.6129032258064516,29,97,[[-0.04317114 -0.04466349 -0.56012034  0.13778696  0.96846273]],[-1.31198313]
32,AMOR.JK,444,110,0.6454545454545455,171,273,[[-0.07679504  0.00291332 -0.01377555  0.05141944  0.06536532]],[-0.47087711]
33,AMRT.JK,967,241,0.4979253112033195,346,621,[[-0.05040488  0.00129918  0.0341693   0.00566315 -1.20899891]],[-0.57971963]
34,ANDI.JK,912,228,1.0,109,803,"[[ 2.15511207e-05  3.05041482e-01  3.67866604e-02  1.82384658e-01
  -1.92133633e-02]]",[-2.00725713]
35,ANJT.JK,967,241,0.6390041493775933,276,691,"[[-8.11130692e-02  6.37019307e-05 -1.53575976e-03  2.12209012e-02
   1.02541126e-01]]",[-0.91825641]
36,ANTM.JK,967,241,0.6307053941908713,408,559,[[-0.00443363  0.00790121 -0.00905691  0.05513151 -0.14789673]],[-0.31154733]
37,APII.JK,967,241,0.6431535269709544,303,664,"[[-6.15237198e-01 -1.13808373e-02 -6.02808933e-02 -6.29612188e-04
  -1.90374036e+00]]",[-0.78392244]
38,APLI.JK,967,241,0.6556016597510373,314,653,"[[-2.85675844e-01 -1.30111802e-02  4.40591892e-02 -1.80964078e-04
  -2.50377910e+00]]",[-0.72693874]
39,APLN.JK,967,241,0.5892116182572614,340,627,[[-0.04378976 -0.01551333  0.01940984 -0.02931899  0.16166262]],[-0.61804911]
40,ARCI.JK,342,85,0.5882352941176471,123,219,[[ 0.00378791  0.15426693  0.02965939 -0.00670872  0.53146357]],[-0.56904334]
41,ARII.JK,967,241,0.6846473029045643,213,754,[[-0.41258081 -0.01946334  0.13890584 -0.01052349  0.18902747]],[-1.28188276]
42,ARKA.JK,727,181,0.9834254143646409,101,626,[[ 0.21408768 -0.00563323 -0.41049319 -0.03569411 -0.91477994]],[-1.86872429]
43,ARKO.JK,141,35,0.5428571428571428,50,91,[[-0.0411583   0.22423092  0.09443503  0.30718384 -0.04568157]],[-0.64457938]
44,ARMY.JK,966,241,1.0,107,859,[[-0.28200787  0.23467591 -0.22483085 -0.01409733  0.60519137]],[-2.10423032]
45,ARNA.JK,967,241,0.6473029045643154,346,621,[[-0.11718521  0.01109286  0.06443599 -0.00155925 -0.05665261]],[-0.57965179]
46,ARTA.JK,966,241,0.6514522821576764,273,693,[[ 0.05087297 -0.00145645 -0.01376596 -0.0189169  -1.2435767 ]],[-0.93662784]
47,ARTO.JK,967,241,0.6348547717842323,382,585,[[ 0.01146047 -0.00315885 -0.00666603 -0.003883   -0.33954125]],[-0.42789687]
48,ASBI.JK,968,241,0.5352697095435685,222,746,[[-0.32918089 -0.0581799   0.08237122  0.00441267 -0.63724575]],[-1.20931059]
49,ASDM.JK,967,241,0.6556016597510373,203,764,[[-0.17433029 -0.05976963 -0.06377372 -0.00286252 -1.81616158]],[-1.3351602]
50,ASGR.JK,967,241,0.6473029045643154,343,624,[[-0.0169825  -0.00375513  0.1272246   0.01676953 -1.15320505]],[-0.5858288]
51,ASHA.JK,164,41,0.5853658536585366,57,107,[[ 0.09026959 -0.00795705  0.16996125  0.07755565  0.63761991]],[-0.61426564]
52,ASII.JK,967,241,0.5975103734439834,411,556,[[-0.07763627 -0.01403683  0.01744501  0.00613644 -1.01944716]],[-0.29631954]
53,ASJT.JK,967,241,0.6556016597510373,329,638,"[[-1.41504367e-01 -1.77811495e-03  1.28765196e-01  1.37958353e-03
  -2.02149333e+00]]",[-0.65976608]
54,ASLC.JK,225,56,0.5178571428571429,77,148,[[-0.06766797 -0.00977006  0.09239091 -0.0143136   0.24341842]],[-0.64719725]
55,ASMI.JK,967,241,0.6721991701244814,288,679,[[ 0.44413089 -0.06836321  0.04494922 -0.04361629  0.91944334]],[-0.87588619]
56,ASPI.JK,604,150,0.64,180,424,[[-0.06464364 -0.02087161 -0.49629252  0.00742943 -0.44087352]],[-0.86571311]
57,ASRI.JK,967,241,0.5850622406639004,365,602,[[-0.17791333 -0.0545772   0.07517902 -0.00748078 -0.68476072]],[-0.49827438]
58,ASRM.JK,968,241,0.7344398340248963,177,791,"[[-4.70189507e-01 -2.50225050e-03 -1.48376767e-02  7.00495114e-03
  -2.98131571e+00]]",[-1.53552636]
59,ASSA.JK,967,241,0.5809128630705395,375,592,[[ 0.00217497 -0.05733759 -0.01470313 -0.01647297 -1.08201981]],[-0.45986291]
60,ATAP.JK,445,111,0.7657657657657657,138,307,[[-0.15603609  0.3224799   0.07870272  0.06959102 -1.31382003]],[-0.80052284]
61,ATIC.JK,968,241,0.6099585062240664,260,708,[[-0.43634953  0.0023724  -0.03916914 -0.01224609 -1.08912081]],[-0.99899483]
62,AUTO.JK,967,241,0.5684647302904564,397,570,[[-0.03685762  0.00430059 -0.03115215 -0.00564759  0.23856929]],[-0.36223289]
63,AVIA.JK,252,62,0.5806451612903226,98,154,[[-0.05815508 -0.01795218  0.12744605  0.00942072 -0.29345193]],[-0.47047788]
64,AXIO.JK,135,33,0.7272727272727273,44,91,[[-0.0484564  -0.13294779  0.4700618   0.03402632 -0.05236693]],[-0.71077172]
65,AYLS.JK,606,151,0.6821192052980133,137,469,[[ 0.04872692  0.0677189   0.1685479  -0.00216844  0.44291012]],[-1.22657281]
66,BABP.JK,968,241,0.6680497925311203,130,838,[[ 0.64328353  0.09301776  0.04951692  0.01029843 -0.28425281]],[-1.86381306]
67,BACA.JK,967,241,0.7053941908713693,243,724,[[-0.25495763  0.03259203 -0.00093755 -0.00084687  0.11240321]],[-1.09362059]
68,BAJA.JK,967,241,0.6763485477178424,312,655,[[-0.17284909  0.01720782 -0.00802582 -0.01721817  0.13009533]],[-0.75256402]
69,BALI.JK,967,241,0.6058091286307054,336,631,"[[-4.85395562e-01  8.09309993e-02 -2.88622883e-03  2.73401315e-04
  -2.31452238e-01]]",[-0.63360061]
70,BANK.JK,420,104,0.5769230769230769,178,242,[[-0.25500206 -0.06910914  0.02959353 -0.03709916  0.01455966]],[-0.30916747]
71,BAPA.JK,967,241,0.6680497925311203,197,770,[[-0.35605355  0.0021011   0.01309077  0.00219595 -1.77208154]],[-1.36410785]
72,BATA.JK,967,241,0.6846473029045643,267,700,[[-0.15689426  0.00398316 -0.08384882  0.00975273 -2.85545859]],[-0.97971265]
73,BAUT.JK,223,55,1.0,17,206,[[-0.07778923  1.3362721  -0.06094843 -0.66178269 -0.31285493]],[-2.57850565]
74,BAYU.JK,967,241,0.7676348547717843,243,724,[[-0.51342571 -0.01260391  0.1193352   0.00056955 -0.3185536 ]],[-1.09961764]
75,BBCA.JK,968,241,0.5269709543568465,436,532,[[-0.13576977 -0.01343725  0.00396894  0.00491929 -1.48838549]],[-0.19697376]
76,BBHI.JK,967,241,0.6680497925311203,355,612,[[ 0.04717751  0.00363054 -0.06365509  0.00165301 -0.48215399]],[-0.54094849]
77,BBKP.JK,967,241,0.7053941908713693,324,643,[[ 0.03182439  0.06317342  0.03726581 -0.02997117 -0.0234828 ]],[-0.70038915]
78,BBLD.JK,967,241,0.6099585062240664,179,788,"[[-2.21411396e-01  3.78745131e-02  9.74340134e-03 -5.13876436e-04
  -1.54236763e+00]]",[-1.48925099]
79,BBMD.JK,967,241,0.8049792531120332,173,794,[[ 0.06368847  0.0887019  -0.09633872  0.00104335  0.09811494]],[-1.53831617]
80,BBNI.JK,967,241,0.5684647302904564,426,541,[[ 0.03537457  0.02290142  0.24943489 -0.00529682  0.26096048]],[-0.24150834]
81,BBRI.JK,967,241,0.5062240663900415,436,531,[[-0.02080245 -0.00751882 -0.00314211  0.00511255 -0.4143762 ]],[-0.19442503]
82,BBSI.JK,497,124,0.5483870967741935,207,290,[[ 0.21238986 -0.2035227   0.02951015 -0.00215579 -0.59908256]],[-0.34166869]
83,BBSS.JK,572,142,0.6619718309859155,151,421,"[[-1.45020703e-01  7.70068755e-02  1.18386020e-01  2.57300946e-04
  -1.39750203e+00]]",[-1.03182459]
84,BBTN.JK,967,241,0.6016597510373444,398,569,[[ 0.00517904  0.00725534  0.00525784 -0.00690266 -0.06433494]],[-0.35532731]
85,BBYB.JK,967,241,0.6224066390041494,329,638,"[[ 3.36172193e-02  7.57507339e-05  8.16687271e-03 -1.15776954e-02
  -7.69703507e-01]]",[-0.65643108]
86,BCIP.JK,967,241,0.6514522821576764,217,750,[[-0.24515641  0.13726487 -0.04740909  0.0112319  -0.54524301]],[-1.24992241]
87,BDKR.JK,7,1,1.0,4,3,[[0.00166902 0.0478292  0.01052906 0.38753354 0.04444318]],[0.3315193]
88,BDMN.JK,967,241,0.6182572614107884,379,588,[[ 0.43511096  0.00268186  0.00552991 -0.00642707  0.33434598]],[-0.43815315]
89,BEBS.JK,399,99,0.9191919191919192,180,219,[[0.43588465 0.02921995 0.0072233  0.01700407 0.97383736]],[-0.20444952]
90,BEEF.JK,829,207,0.6811594202898551,261,568,[[-0.13970543  0.12695827 -0.00853578 -0.00656676 -0.8463238 ]],[-0.78045695]
91,BEER.JK,38,9,0.6666666666666666,14,24,[[-0.0087194  -0.81941335 -1.06878732  0.2641119  -0.02228154]],[-0.67499535]
92,BELI.JK,72,18,0.7222222222222222,20,52,[[-0.0018408  -0.26882937 -0.03699949  0.21558425 -0.28176382]],[-1.05043565]
93,BELL.JK,968,241,0.6431535269709544,290,678,[[ 0.58508526  0.0113284   0.05600248  0.01321266 -1.45287294]],[-0.85736456]
94,BESS.JK,592,147,0.5918367346938775,249,343,[[ 0.32380734 -0.01966513  0.04099345 -0.01725292  1.5234207 ]],[-0.33252693]
95,BEST.JK,967,241,0.6182572614107884,335,632,[[ 0.00364092  0.08067424  0.04756548 -0.01605545 -0.06545159]],[-0.635618]
96,BFIN.JK,967,241,0.5477178423236515,349,618,[[ 0.02361635 -0.01244681 -0.00744085  0.08409331 -0.69925588]],[-0.57267528]
97,BGTG.JK,967,241,0.6804979253112033,270,697,[[ 0.04483138 -0.02984035 -0.07177559 -0.00810724 -0.7028834 ]],[-0.94519666]
98,BHAT.JK,571,142,0.6267605633802817,243,328,[[ 0.01560903  0.01110189  0.09921547 -0.00156315 -0.76224475]],[-0.29445559]
99,BHIT.JK,968,241,0.7302904564315352,245,723,[[-0.12321442 -0.00791242  0.16160488  0.01623288 -0.98234752]],[-1.08799185]
100,BIKA.JK,967,241,0.6597510373443983,309,658,[[-0.8838199   0.01627765 -0.01097338  0.00203326 -1.50365075]],[-0.74749889]
101,BIKE.JK,196,49,0.7346938775510204,74,122,[[ 0.04307215  0.02384834 -0.01079709 -0.09804108  0.02074882]],[-0.49116354]
102,BIMA.JK,967,241,0.6721991701244814,162,805,[[-0.0004303  -0.00164576  0.02000121  0.00065225 -0.00261456]],[-0.17879749]
103,BINA.JK,967,241,0.6639004149377593,387,580,[[ 0.00637106 -0.00183308 -0.05588487  0.00974711  0.02974932]],[-0.41038956]
104,BINO.JK,259,64,0.734375,95,164,[[ 0.01140323  0.04924807 -0.2428637  -0.02051621 -0.49067527]],[-0.54180087]
105,BIPI.JK,968,241,0.5767634854771784,63,905,"[[ 2.37285517e-02  3.35195679e-02 -3.58817086e-04  1.90910830e-02
  -7.99137709e-01]]",[-2.67194243]
106,BIPP.JK,967,241,0.8298755186721992,214,753,[[-0.34397931 -0.06589574 -0.01432071  0.0051168  -1.95402852]],[-1.2664199]
107,BIRD.JK,967,241,0.5601659751037344,354,613,[[ 0.02698821 -0.02088052  0.00480606  0.02040104  0.76430176]],[-0.551698]
108,BISI.JK,967,241,0.6141078838174274,338,629,[[ 0.18905531 -0.01816155  0.02299231  0.0121462   0.06030694]],[-0.62765819]
109,BJBR.JK,967,241,0.6348547717842323,413,554,[[-0.13867165 -0.01800521 -0.00174367 -0.01212649  0.19538568]],[-0.29695546]
110,BJTM.JK,967,241,0.7427385892116183,350,617,"[[-1.50283792e-01 -1.43809293e-02  3.04504207e-03  9.34499731e-04
  -1.08382981e+00]]",[-0.56188437]
111,BKDP.JK,967,241,0.6970954356846473,217,750,[[-0.20669807 -0.00522982 -0.01657012 -0.01899002 -2.19488757]],[-1.24621976]
112,BKSL.JK,967,241,0.8672199170124482,243,724,[[-0.20698063  0.0161962   0.23988453 -0.00806352 -1.48105712]],[-1.09382019]
113,BKSW.JK,967,241,0.6390041493775933,295,672,[[-0.34889338  0.04293941  0.02286369  0.00452223 -0.26931671]],[-0.82925038]
114,BLTZ.JK,968,241,0.7178423236514523,145,823,[[ 0.00187388  0.01620482  0.11823917  0.01753136 -0.00071264]],[-1.745074]
115,BLUE.JK,728,182,0.6758241758241759,288,440,[[-0.01894351 -0.03621485  0.00344882  0.01215499 -1.07060335]],[-0.41546168]
116,BMAS.JK,967,241,0.5892116182572614,286,681,[[ 0.00548407 -0.04800228 -0.01100329  0.00043675  0.16735598]],[-0.87184016]
117,BMBL.JK,36,8,0.875,12,24,[[-0.00447113  0.01714939  0.19406661 -0.40017108  0.82857374]],[-0.76300184]
118,BMHS.JK,337,84,0.6785714285714286,109,228,[[-0.11888399  0.01538876 -0.01763378  0.01441063 -0.06032884]],[-0.74484554]
119,BMRI.JK,968,241,0.5145228215767634,437,531,[[-0.1227588   0.15864897 -0.01779794 -0.01005929 -0.17473047]],[-0.20019024]
120,BMSR.JK,967,241,0.6597510373443983,333,634,[[-0.78207606 -0.0011482   0.01761644  0.00926494 -0.78472686]],[-0.6382616]
121,BMTR.JK,967,241,0.6099585062240664,357,610,[[ 0.00011319 -0.00653155 -0.01243129  0.01393735 -0.00296677]],[-0.54078275]
122,BNBA.JK,967,241,0.6473029045643154,362,605,[[ 0.35357798 -0.00852423  0.0051541  -0.03199572 -0.61246219]],[-0.5147314]
123,BNBR.JK,968,241,0.7053941908713693,13,955,[[0. 0. 0. 0. 0.]],[0.]
124,BNGA.JK,967,241,0.6307053941908713,363,604,[[-0.19294646  0.0252323  -0.0439644   0.01672662  0.44944859]],[-0.51635365]
125,BNII.JK,967,241,0.7136929460580913,331,636,[[-0.06974296 -0.02617275  0.01099696 -0.00131712 -1.18609165]],[-0.64943162]
126,BNLI.JK,967,241,0.6514522821576764,367,600,[[ 0.13764597 -0.01865583  0.01389618  0.00647323  0.33993833]],[-0.49853237]
127,BOBA.JK,273,68,0.6323529411764706,87,186,[[-0.0923393  -0.06619269 -0.18303454  0.03567958 -0.89583002]],[-0.74799404]
128,BOGA.JK,967,241,0.6307053941908713,354,613,[[-0.03017269 -0.01730369 -0.04537326 -0.00386103  1.19767336]],[-0.56218646]
129,BOLA.JK,740,184,0.6630434782608695,277,463,[[-0.03766664 -0.01809966  0.0648877   0.02145091 -1.24712781]],[-0.51807028]
130,BOLT.JK,967,241,0.6846473029045643,268,699,[[-0.56451283  0.00496359  0.00916146 -0.01132683 -0.47832528]],[-0.95509572]
131,BOSS.JK,967,241,0.6680497925311203,326,641,[[-0.11597201  0.0022919   0.03578864  0.00483626  0.23605539]],[-0.6771019]
132,BPFI.JK,968,241,0.6846473029045643,99,869,[[ 0.1518728  -0.01104472  0.02449977  0.00765847 -0.42439203]],[-2.18166879]
133,BPII.JK,967,241,0.9045643153526971,32,935,[[0. 0. 0. 0. 0.]],[0.]
134,BPTR.JK,936,233,0.6566523605150214,312,624,"[[-1.01235128e-01  4.49559982e-02  2.18922832e-02 -1.30948763e-03
  -2.10148874e+00]]",[-0.69475902]
135,BRAM.JK,967,241,0.6970954356846473,170,797,[[ 0.16241431 -0.01373298  0.00055541  0.01011745  0.15839476]],[-1.55065525]
136,BRIS.JK,967,241,0.6016597510373444,342,625,[[ 0.22343113 -0.01089559  0.11761437  0.02311738 -0.07760213]],[-0.59765718]
137,BRMS.JK,967,241,0.6224066390041494,215,752,"[[-1.68242939e-02  4.13432454e-03 -1.70458282e-03  7.21883067e-04
  -9.24848887e-01]]",[-1.24923721]
138,BRNA.JK,967,241,0.8547717842323651,190,777,[[-0.3299189   0.03277652 -0.00335672  0.00102297 -0.56580242]],[-1.40775445]
139,BRPT.JK,968,241,0.5933609958506224,416,552,[[ 0.16248628 -0.03493237  0.14636725  0.01355377 -0.56905699]],[-0.27960965]
140,BSBK.JK,72,18,1.0,12,60,[[-0.09118153  0.39881062  1.0983249  -0.2761562   0.22628238]],[-1.64866809]
141,BSDE.JK,967,241,0.5850622406639004,392,575,"[[-3.30036872e-02  1.05557036e-02 -2.84660597e-03  2.02744972e-04
  -6.29544088e-01]]",[-0.38322927]
142,BSIM.JK,967,241,0.6639004149377593,308,659,"[[-4.39998658e-01 -2.77862267e-02 -4.96723741e-03  2.28840960e-04
  -1.47197957e+00]]",[-0.75509699]
143,BSML.JK,247,61,0.7377049180327869,86,161,[[ 0.04133094 -0.02287197  0.00482798  0.00336309  0.41289366]],[-0.62941083]
144,BSSR.JK,967,241,0.5186721991701245,349,618,[[-0.09650249  0.03274267  0.00452017  0.03126821 -1.01125922]],[-0.559599]
145,BTEK.JK,967,241,1.0,135,832,[[-0.36208336 -0.00297289  0.02598922  0.17594079 -1.00955641]],[-1.82234808]
146,BTON.JK,967,241,0.6182572614107884,353,614,"[[-3.75681175e-01  1.51833317e-02 -7.31220588e-03 -8.47704697e-04
  -3.40988036e+00]]",[-0.55516493]
147,BTPN.JK,967,241,0.6224066390041494,385,582,[[-0.03108865 -0.00539168 -0.00532788 -0.00183113 -0.85090502]],[-0.40908446]
148,BTPS.JK,967,241,0.6141078838174274,432,535,[[-0.09785554  0.03426847  0.07118554  0.00130474  0.32408912]],[-0.21678822]
149,BUAH.JK,124,30,0.16666666666666666,55,69,[[ 0.10142768  0.12239117  0.17483078 -0.04570027  0.19884833]],[-0.24065693]
150,BUDI.JK,967,241,0.6639004149377593,321,646,[[-0.12932358 -0.02816734  0.00436788 -0.00308544 -1.3216528 ]],[-0.69786856]
151,BUKA.JK,320,79,0.6329113924050633,123,197,[[ 0.02038593  0.24242625  0.06173173 -0.01071389 -0.21621495]],[-0.47752004]
152,BUKK.JK,967,241,0.6141078838174274,355,612,[[-0.51546349  0.02289093  0.22797866 -0.00735373 -1.44431225]],[-0.53405631]
153,BULL.JK,968,241,0.5892116182572614,385,583,[[-0.07099776 -0.00057903 -0.00474449 -0.0064095  -0.14127548]],[-0.41347551]
154,BUMI.JK,967,241,0.5518672199170125,257,710,[[0.05805484 0.04044974 0.04250514 0.01723382 0.16938842]],[-1.02148941]
155,BVIC.JK,967,241,0.6473029045643154,330,637,[[-0.26834592  0.01192897  0.1315334   0.06663776 -0.65571324]],[-0.6513649]
156,BWPT.JK,967,241,0.7178423236514523,344,623,[[-0.22267878  0.00640079 -0.07319686  0.00057928  0.06771919]],[-0.59877175]
157,BYAN.JK,968,241,0.47717842323651455,279,689,[[ 0.20523586 -0.00037807 -0.02311562  0.00848395 -0.11823337]],[-0.90159613]
158,CAKK.JK,870,217,0.6221198156682027,228,642,[[-0.10807222 -0.04551888  0.13688777 -0.0025013  -1.50490448]],[-1.04984362]
159,CAMP.JK,967,241,0.5975103734439834,355,612,[[ 0.0038028  -0.00949379 -0.06176351 -0.00096388 -0.52647107]],[-0.53920246]
160,CANI.JK,968,241,0.6556016597510373,255,713,"[[-6.79472244e-01 -1.41455819e-04  1.17144395e-02  2.26716880e-02
   1.95505775e-01]]",[-1.03239617]
161,CARE.JK,588,147,0.6054421768707483,221,367,[[-0.04752458 -0.08366129  0.00306041  0.11187611  0.33178451]],[-0.51605162]
162,CARS.JK,967,241,0.7634854771784232,160,807,[[-0.17285715  0.00676542  0.63739328  0.01949571 -0.09826717]],[-1.61389264]
163,CASA.JK,967,241,0.6721991701244814,274,693,[[-0.0911452   0.00267711 -0.01790437  0.03390425 -0.40112225]],[-0.92391566]
164,CASH.JK,562,140,0.65,203,359,[[-0.14116721 -0.29973079  0.07850368  0.03864458  0.6075537 ]],[-0.57708478]
165,CASS.JK,968,241,0.5601659751037344,253,715,[[-0.18845549  0.05162446  0.03060568 -0.00283044 -1.03333019]],[-1.03800428]
166,CBMF.JK,573,143,1.0,166,407,[[ 0.60270632  0.01243657  0.10865471 -0.03570541  0.12604899]],[-0.90258023]
167,CBPE.JK,38,9,0.6666666666666666,15,23,[[-0.01707133  0.08491607  0.77877388  0.00994066 -0.24384975]],[-0.49761715]
168,CBRE.JK,37,9,0.8888888888888888,8,29,[[-0.01131284  0.0197215  -0.04888211 -0.32528243 -0.17484303]],[-1.2616823]
169,CBUT.JK,72,18,0.4444444444444444,34,38,[[ 0.00166202  0.08348032 -0.56050275 -0.43990217  0.07004296]],[-0.16240287]
170,CCSI.JK,740,184,0.7282608695652174,282,458,[[-0.0512777   0.08722815 -0.05528291 -0.00756098 -1.36755147]],[-0.48010161]
171,CEKA.JK,967,241,0.6348547717842323,391,576,[[-0.06336913  0.00739336 -0.05591281  0.00937306 -1.3817478 ]],[-0.37860219]
172,CENT.JK,967,241,0.7095435684647303,333,634,[[ 0.04796627 -0.03140572  0.09697949  0.00351642 -0.97905505]],[-0.63967961]
173,CFIN.JK,967,241,0.6224066390041494,334,633,[[-0.17243087 -0.03782198  0.0388543  -0.02807544 -0.77570513]],[-0.64446324]
174,CHEM.JK,141,35,0.6571428571428571,45,96,[[-0.11582066  0.04739377 -0.3558871   0.01001976 -0.31586819]],[-0.75137977]
175,CHIP.JK,20,5,0.4,9,11,[[-0.03907916 -0.08121886 -0.13243974  0.39305008  0.08573486]],[-0.2454734]
176,CINT.JK,967,241,0.7302904564315352,309,658,"[[-5.28697449e-01  2.94907762e-03  1.96922938e-03  7.11208319e-03
  -2.47730575e+00]]",[-0.75828835]
177,CITA.JK,968,241,0.6680497925311203,283,685,[[-0.14599666 -0.0008888   0.00299792  0.02242517 -0.11620983]],[-0.88329405]
178,CITY.JK,888,221,0.6832579185520362,290,598,[[-0.23493363  0.04945734 -0.04113822 -0.00265452 -1.27298141]],[-0.73191929]
179,CLAY.JK,824,206,0.7475728155339806,246,578,[[-0.14238263 -0.00793809  0.01873129  0.02190232 -1.11477102]],[-0.85125505]
180,CLEO.JK,967,241,0.5975103734439834,336,631,[[-0.05733841  0.03885955  0.00436354  0.00970984 -0.04935186]],[-0.63094704]
181,CLPI.JK,967,241,0.6763485477178424,343,624,[[ 0.08851397 -0.00866482 -0.01829626  0.01029552 -1.82908311]],[-0.59610077]
182,CMNP.JK,967,241,0.6680497925311203,383,584,[[-0.19848164  0.07681518 -0.0207481   0.00649425 -0.19605824]],[-0.41663827]
183,CMNT.JK,303,75,0.72,114,189,[[ 0.01050709 -0.14447238 -0.02167043  0.00193066  0.16905168]],[-0.51776536]
184,CMRY.JK,253,63,0.49206349206349204,117,136,[[-0.11736742  0.00718402 -0.17076167 -0.00302153 -0.11389685]],[-0.13778323]
185,CNTX.JK,966,241,0.7468879668049793,238,728,[[-0.64684205  0.02577571  0.00433841  0.02700455 -2.5317135 ]],[-1.12549508]
186,COAL.JK,108,26,0.6153846153846154,30,78,[[-0.05044376  0.05938524 -0.23320365  0.41764639  0.95616634]],[-0.99116715]
187,COCO.JK,790,197,0.6040609137055838,239,551,[[-0.15312882  0.02605883  0.01844037  0.00072229 -0.33076154]],[-0.82784156]
188,COWL.JK,966,241,1.0,102,864,[[-0.16548354  0.09728629  0.6721066  -0.00954737 -0.3606115 ]],[-2.13650329]
189,CPIN.JK,967,241,0.5518672199170125,431,536,[[-0.04453373 -0.00223642 -0.00255523  0.00935029 -0.69790055]],[-0.21837028]
190,CPRI.JK,777,194,1.0,25,752,[[-0.12847269  1.35317661  0.75570524 -0.05593475 -0.43146032]],[-3.32221685]
191,CRAB.JK,123,30,0.7333333333333333,41,82,[[-0.04183734 -0.9842409  -0.66718483  0.53902157 -0.89452799]],[-0.67296486]
192,CSAP.JK,967,241,0.6099585062240664,310,657,[[-0.26775578  0.00453905  0.04363316  0.02402567 -1.57903161]],[-0.74544107]
193,CSIS.JK,967,241,0.7095435684647303,272,695,[[-0.03745743 -0.01328175  0.0489545  -0.0091137  -0.94424709]],[-0.93850728]
194,CSMI.JK,573,143,1.0,130,443,[[ 0.52699646  0.50948982  0.03156198 -0.03864035 -0.14810065]],[-1.24957257]
195,CSRA.JK,625,156,0.5961538461538461,229,396,[[-0.05682592  0.15511362  0.0492054  -0.02845231 -0.09969091]],[-0.55238466]
196,CTRA.JK,967,241,0.6224066390041494,399,568,[[ 0.03901872 -0.04784043 -0.00641112 -0.00377967  0.03001281]],[-0.35767154]
197,CTTH.JK,966,241,1.0,211,755,"[[-2.57026338e-01  1.60841453e-01 -2.27048659e-03 -1.22820426e-02
  -2.45271071e+00]]",[-1.29498042]
198,CUAN.JK,4,1,0.0,2,2,[[-0.00657924 -0.07400386 -0.03361651 -0.09117165  0.00336348]],[8.29308753e-05]
199,DADA.JK,604,150,1.0,53,551,[[-0.37442091  0.03783494  0.18214944  0.05407383  0.94901987]],[-2.34580611]
200,DART.JK,968,241,0.6473029045643154,250,718,[[-0.63819709  0.00804262 -0.01136293  0.00880604 -0.98902369]],[-1.05553783]
201,DAYA.JK,968,241,0.5892116182572614,212,756,[[-0.7846786  -0.00432399 -0.0527872   0.03524891  0.07230486]],[-1.27917448]
202,DCII.JK,434,108,0.9166666666666666,96,338,[[ 0.6498485  -0.00069047  0.12163682  0.0081366   0.32324497]],[-1.27619804]
203,DEAL.JK,864,216,1.0,246,618,[[ 0.46217274 -0.00321101 -0.18012657 -0.00185886  0.96977848]],[-0.9348934]
204,DEFI.JK,967,241,1.0,233,734,[[ 0.16030121 -0.00269521 -0.01077167  0.00172329  0.60109498]],[-1.16153857]
205,DEPO.JK,259,64,0.765625,104,155,[[-0.06720482  0.01963965  0.0043082   0.0048809  -0.98057929]],[-0.37931873]
206,DEWI.JK,136,34,0.5,63,73,[[-0.16670996 -0.04427471 -0.04832291 -0.0184449  -0.29338811]],[-0.13709162]
207,DFAM.JK,967,241,0.7510373443983402,315,652,[[ 0.23807985 -0.10468369 -0.00201634 -0.0064374  -1.46162212]],[-0.73614618]
208,DGIK.JK,967,241,0.6597510373443983,128,839,[[0. 0. 0. 0. 0.]],[0.]
209,DGNS.JK,428,107,0.6822429906542056,162,266,[[-0.05799616 -0.1896917  -0.2370348   0.00973399 -0.3902568 ]],[-0.50737748]
210,DIGI.JK,895,223,0.9506726457399103,221,674,[[-0.43943654 -0.05072161 -0.03248086 -0.02737325 -1.40787844]],[-1.12810505]
211,DILD.JK,967,241,0.6348547717842323,337,630,[[-0.05936108  0.02849741  0.02334733  0.0078296  -0.83808938]],[-0.62547053]
212,DIVA.JK,856,213,0.5821596244131455,331,525,[[ 0.14534486 -0.12974291  0.12608647  0.0070462   0.8386541 ]],[-0.46017861]
213,DKFT.JK,967,241,0.6431535269709544,341,626,[[-0.20801947  0.00396563  0.05098523  0.00167123 -1.24235864]],[-0.60179162]
214,DLTA.JK,967,241,0.6224066390041494,315,652,[[-0.01194549  0.04588389  0.00346429  0.01992891 -0.95621702]],[-0.73033821]
215,DMAS.JK,967,241,0.6721991701244814,378,589,"[[-1.82037340e-02 -1.05579126e-02 -4.42142554e-02  8.70278940e-04
  -1.08929133e+00]]",[-0.43856962]
216,DMMX.JK,668,167,0.6287425149700598,283,385,[[ 0.93133719 -0.24557139  0.00206871 -0.00802621  0.07514185]],[-0.3225111]
217,DMND.JK,618,154,0.7532467532467533,205,413,[[-0.23470514 -0.03475661  0.26330074  0.00869527 -2.77796893]],[-0.70384543]
218,DNAR.JK,968,241,0.6514522821576764,295,673,[[-0.14449078 -0.02460714  0.03376017  0.0187477  -0.63618424]],[-0.83157495]
219,DNET.JK,967,241,0.6680497925311203,237,730,"[[-1.77651251e-01  1.54149744e-04 -9.05519342e-02 -1.08508378e-03
  -1.56431371e+00]]",[-1.12386141]
220,DOID.JK,967,241,0.5601659751037344,366,601,[[-0.04221057 -0.00788277  0.04843475 -0.0022522  -1.04156879]],[-0.49442127]
221,DPNS.JK,968,241,0.6058091286307054,259,709,[[-0.11261103 -0.0172972  -0.00175235 -0.03517805 -1.43495195]],[-1.01149111]
222,DPUM.JK,966,241,1.0,162,804,[[-0.54563585 -0.00107623 -0.00355616  0.00325106  0.10800946]],[-1.6081899]
223,DRMA.JK,245,61,0.5081967213114754,98,147,[[-0.06983863 -0.10042238 -0.13002045 -0.02216455 -0.53932309]],[-0.42204624]
224,DSFI.JK,967,241,0.6970954356846473,317,650,[[-0.40474913  0.00450614  0.00538343  0.00291951 -2.22644729]],[-0.71520267]
225,DSNG.JK,967,241,0.6058091286307054,346,621,[[-0.10705202  0.01244925 -0.01222649 -0.00384535 -0.19571922]],[-0.58643586]
226,DSSA.JK,967,241,0.8962655601659751,125,842,[[0.03039464 0.02118037 0.00547792 0.00271748 0.00927229]],[-1.91366582]
227,DUCK.JK,881,220,1.0,227,654,[[0.02376746 0.10012679 0.09177543 0.00149477 0.51719238]],[-1.05991236]
228,DVLA.JK,967,241,0.6846473029045643,307,660,[[-0.24702277  0.01202508  0.00714054 -0.00681963 -3.12955484]],[-0.7751625]
229,DWGL.JK,967,241,0.6058091286307054,341,626,"[[-2.74938908e-02  5.85581815e-04 -1.08006319e-02  8.51006476e-04
  -1.30432547e+00]]",[-0.60513009]
230,DYAN.JK,967,241,0.6390041493775933,280,687,[[-0.33252989  0.03608539 -0.05401827 -0.00676125 -1.46435193]],[-0.89114857]
231,EAST.JK,728,181,0.6353591160220995,241,487,[[-0.02596656 -0.01207991  0.03119676 -0.05127709 -0.69619865]],[-0.69992886]
232,ECII.JK,967,241,0.8174273858921162,107,860,[[-0.12366368 -0.00156503 -0.03759733  0.00527918  0.03002942]],[-2.08586828]
233,EDGE.JK,416,103,0.8349514563106796,142,274,[[-0.04326727 -0.13184507  0.05175182  0.01043939 -1.36435471]],[-0.66829236]
234,EKAD.JK,968,241,0.7136929460580913,375,593,[[-0.05045208 -0.00922489 -0.01898926 -0.04119146 -0.98635323]],[-0.448336]
235,ELIT.JK,38,9,0.2222222222222222,19,19,[[-0.02286721 -0.37692045  0.01890898 -0.01215887 -0.34047482]],[0.01455903]
236,ELPI.JK,124,31,0.6129032258064516,42,82,[[-0.02485154 -0.26863645 -0.26141007 -0.07926279 -1.15151246]],[-0.69251663]
237,ELSA.JK,967,241,0.5643153526970954,377,590,[[-0.11798048  0.00561807  0.002703   -0.01490003 -1.06481945]],[-0.44252753]
238,EMDE.JK,967,241,0.6887966804979253,165,802,[[-0.31394323  0.02835391  0.01662222  0.01645272 -0.07591297]],[-1.58675121]
239,ENAK.JK,218,54,0.5555555555555556,94,124,[[ 0.09660084 -0.13959793  0.09824174  0.00429787  1.99022649]],[-0.30297406]
240,ENRG.JK,967,241,0.5809128630705395,292,675,[[-0.00840086 -0.00998109 -0.01517912  0.00084317 -0.166113  ]],[-0.83408496]
241,ENVY.JK,728,181,1.0,88,640,[[-0.13267147  0.55480102  0.30332077  0.22046857  0.71800723]],[-1.96044243]
242,ENZO.JK,493,123,0.8211382113821138,61,432,[[-0.02147641  0.1786449   0.17054273 -0.01246216 -0.87717018]],[-1.94960452]
243,EPAC.JK,532,132,1.0,96,436,[[-0.14465661  0.02637169 -0.40803266 -0.06307767 -0.72798935]],[-1.5472712]
244,EPMT.JK,967,241,0.6224066390041494,275,692,[[-0.11740298  0.00979965 -0.04837277 -0.00132193 -0.57428885]],[-0.91927488]
245,ERAA.JK,968,241,0.6058091286307054,399,569,[[-0.05868393 -0.01088525 -0.00404007 -0.01225565 -0.90373561]],[-0.34828905]
246,ERTX.JK,967,241,0.6265560165975104,309,658,[[-0.75279636  0.01798397  0.00291418  0.01937552 -1.90171735]],[-0.75460731]
247,ESIP.JK,654,163,0.7791411042944786,218,436,[[-0.33664405  0.01880506  0.01962459  0.00468886 -0.09381979]],[-0.69232459]
248,ESSA.JK,967,241,0.5809128630705395,375,592,[[-0.13110009 -0.04205041 -0.00678835  0.00725746 -1.02074795]],[-0.4542709]
249,ESTA.JK,592,147,0.6870748299319728,223,369,[[-0.08491581  0.00653376 -0.00234289  0.00109335 -0.64832813]],[-0.50561181]
250,ESTI.JK,967,241,0.8132780082987552,281,686,[[-0.05032112 -0.00281309  0.01396693 -0.00501609 -0.57053501]],[-0.89224822]
251,ETWA.JK,967,241,0.6265560165975104,154,813,"[[-3.62770713e-01 -4.94934289e-04  5.97671380e-02 -1.12951037e-02
  -1.69415083e+00]]",[-1.66582167]
252,EURO.JK,124,31,0.3225806451612903,68,56,[[ 0.13804007  0.51656377  0.08508451  0.04566808 -0.32250914]],[0.16704053]
253,EXCL.JK,967,241,0.6016597510373444,398,569,[[-0.28580948 -0.00601003 -0.04705145  0.00217349 -0.44224439]],[-0.3595733]
254,FAPA.JK,436,108,0.6018518518518519,188,248,[[-0.02887081 -1.06476298 -0.42730691 -0.01315066 -1.24650573]],[-0.27242173]
255,FAST.JK,968,241,0.7385892116182573,288,680,[[-0.27516587 -0.01829273 -0.01756851  0.00377495 -1.16975104]],[-0.85301854]
256,FASW.JK,967,241,0.5809128630705395,186,781,"[[ 4.88031060e-11 -6.89887316e-04 -9.38861732e-05  1.17269848e-03
  -1.88492394e-09]]",[-1.08815071e-06]
257,FILM.JK,919,229,0.5283842794759825,368,551,[[ 0.59259763 -0.00815722 -0.16339373  0.01166259  0.21570032]],[-0.40272817]
258,FIMP.JK,383,95,0.7157894736842105,118,265,[[ 0.01526197  0.12028165  0.01797565  0.05617057 -0.94709504]],[-0.81676226]
259,FIRE.JK,967,241,0.7302904564315352,313,654,[[ 0.0639729   0.01680191  0.12883872  0.00241835 -0.36877313]],[-0.73903141]
260,FISH.JK,966,241,0.7717842323651453,134,832,[[ 0.37683846  0.00212044  0.01165914 -0.01415658  0.32472178]],[-1.84267576]
261,FITT.JK,743,185,0.6594594594594595,239,504,[[-0.14781924 -0.0928211  -0.035874    0.00235682 -0.19229391]],[-0.75447863]
262,FLMC.JK,335,83,1.0,81,254,[[ 0.08580948  0.03251688  0.08380475 -0.00363041  1.16848867]],[-1.14503355]
263,FMII.JK,967,241,0.7136929460580913,206,761,[[-0.3302412   0.05682626 -0.05172254  0.00143617  0.05823666]],[-1.31842544]
264,FOOD.JK,831,207,0.6280193236714976,259,572,[[-0.46677113 -0.04553611  0.00414261 -0.0218103   0.06038468]],[-0.79637756]
265,FORU.JK,967,241,0.6639004149377593,232,735,[[-0.05340427 -0.01852869  0.00262737 -0.01558217 -1.33742356]],[-1.15498441]
266,FORZ.JK,966,241,1.0,133,833,[[ 0.07335009 -0.43180234  0.76271547  0.06246388  0.58033453]],[-1.87551525]
267,FPNI.JK,967,241,0.6390041493775933,344,623,[[-0.12261419 -0.00711851  0.0312983  -0.00060043 -0.51827538]],[-0.5896582]
268,FREN.JK,967,241,0.7012448132780082,368,599,"[[-3.36345352e-02  6.63795089e-04 -8.32502984e-03  7.68426154e-03
  -8.16241097e-01]]",[-0.47839204]
269,FUJI.JK,728,181,0.6519337016574586,279,449,"[[-1.56705003e-01 -5.49105011e-02  5.72477158e-02 -2.15618838e-03
  -2.93216724e+00]]",[-0.47505086]
270,FUTR.JK,10,2,0.5,5,5,[[ 0.01055778 -0.019851   -0.04065408 -0.0349909  -0.08995226]],[-0.00608174]
271,FWCT.JK,24,6,0.8333333333333334,6,18,"[[-5.95236987e-04 -2.05151993e-02  1.55455262e-02 -8.36027737e-01
  -1.16920984e-01]]",[-1.28652432]
272,GAMA.JK,966,241,1.0,39,927,[[0. 0. 0. 0. 0.]],[0.]
273,GDST.JK,967,241,0.6556016597510373,307,660,"[[-1.87627172e-01 -1.39847212e-02  2.95524480e-02  1.25266657e-03
  -1.37675172e+00]]",[-0.76811129]
274,GDYR.JK,967,241,0.6514522821576764,193,774,[[ 0.00173244 -0.02992916  0.13990873 -0.00061784 -0.20755795]],[-1.39078903]
275,GEMA.JK,967,241,0.7302904564315352,224,743,[[-0.36241211 -0.06653231  0.00419918  0.00243296 -1.06148807]],[-1.19889719]
276,GEMS.JK,968,241,0.6141078838174274,115,853,[[0.21996917 0.02153477 0.02336467 0.0146976  1.4280162 ]],[-2.00360689]
277,GGRM.JK,967,241,0.5643153526970954,418,549,[[-0.05883715  0.07425039 -0.03451615 -0.00458529 -0.19350755]],[-0.27178067]
278,GGRP.JK,686,171,0.6549707602339181,268,418,[[-0.30021526  0.01290479  0.0041825  -0.0094623  -0.82591426]],[-0.43815326]
279,GHON.JK,967,241,0.6721991701244814,289,678,[[-0.72562005 -0.00328974 -0.0023315   0.00530556 -1.5160624 ]],[-0.84633622]
280,GIAA.JK,967,241,0.8796680497925311,253,714,[[ 0.07600647  0.00498628 -0.00174488 -0.01289751  0.63483623]],[-1.040428]
281,GJTL.JK,967,241,0.6141078838174274,366,601,[[-0.24800876  0.01625451 -0.0202078   0.0163008  -0.16382905]],[-0.49424509]
282,GLOB.JK,966,241,0.6887966804979253,320,646,[[-0.68805131 -0.09826611 -0.0018215   0.04057981 -0.61530508]],[-0.70159882]
283,GLVA.JK,632,158,0.5063291139240507,224,408,"[[-3.14094192e-01 -7.17911231e-02  1.88835032e-03 -4.04560917e-03
  -2.29111964e+00]]",[-0.59391474]
284,GMFI.JK,967,241,0.7676348547717843,313,654,[[-0.0242205  -0.03498874 -0.01212962  0.00414813 -0.80709548]],[-0.7331384]
285,GMTD.JK,966,241,0.995850622406639,73,893,[[-0.07992529 -0.04623144 -0.02349148 -0.00110141 -0.75273618]],[-2.51905476]
286,GOLD.JK,968,241,0.6431535269709544,296,672,[[-0.64184729 -0.00798773 -0.01096017 -0.00346481 -2.61784506]],[-0.82944419]
287,GOLL.JK,967,241,1.0,1,966,"[[ 6.30245054e-05 -3.84467499e-02 -3.58598360e-02 -3.79891647e-03
  -1.72755265e-03]]",[-6.87590962]
288,GOOD.JK,883,220,0.6590909090909091,343,540,[[-0.24550233  0.31554807  0.03668985 -0.00245999 -0.25730171]],[-0.45610241]
289,GOTO.JK,184,46,0.5869565217391305,66,118,[[ 0.11502474 -0.38932035  0.15677339 -0.05904873 -0.24081868]],[-0.59895501]
290,GPRA.JK,967,241,0.6639004149377593,281,686,"[[-1.80855922e-01 -1.04275511e-03 -2.92545895e-02  1.92847716e-03
  -2.09772224e+00]]",[-0.89455809]
291,GPSO.JK,304,76,0.6447368421052632,103,201,"[[-2.17397887e-01  6.60993218e-02  2.22730105e-01 -7.51955396e-04
  -7.84041809e-01]]",[-0.67034701]
292,GSMF.JK,967,241,0.6970954356846473,274,693,[[-0.52122631 -0.00270954  0.05243524  0.00937235  0.06122084]],[-0.93635994]
293,GTBO.JK,967,241,0.7966804979253111,172,795,[[-0.56804719  0.02538405 -0.02559418  0.09790371 -2.45547374]],[-1.55724608]
294,GTSI.JK,303,75,0.8533333333333334,79,224,[[-0.12462728  0.00507639  0.03973294  0.17413391  0.34254648]],[-1.0573233]
295,GULA.JK,127,31,0.5483870967741935,63,64,[[-0.04190737  0.29848154 -0.03478492 -0.01432613 -0.7922058 ]],[-0.00559112]
296,GWSA.JK,967,241,0.6016597510373444,323,644,"[[-2.08515597e-01 -1.02562262e-01  2.34564691e-02 -5.72060081e-04
  -1.85939590e+00]]",[-0.68928588]
297,GZCO.JK,967,241,0.6348547717842323,124,843,[[0. 0. 0. 0. 0.]],[0.]
298,HAIS.JK,307,76,0.6447368421052632,110,197,[[-0.1711517  -0.00677549 -0.03097888 -0.05298116  0.09367673]],[-0.59180813]
299,HALO.JK,20,5,0.4,12,8,[[ 0.03445905  0.16971867  0.1297906  -0.68305569  0.12336322]],[0.57724417]
300,HATM.JK,132,32,0.59375,39,93,[[-0.08060427 -0.06194283 -0.37521259 -0.03013212 -0.20746098]],[-0.91176777]
301,HDFA.JK,968,241,0.6182572614107884,254,714,[[-1.01745804  0.07861306  0.01289816  0.00683628 -0.58832962]],[-1.03302032]
302,HDIT.JK,725,181,0.8011049723756906,246,479,[[ 0.11816223  0.08235429 -0.05014108 -0.0123156  -0.35665193]],[-0.67935993]
303,HEAL.JK,966,241,0.5601659751037344,377,589,[[ 0.04058007  0.02997278  0.0680212  -0.00990576 -0.26135596]],[-0.44693448]
304,HELI.JK,967,241,0.6514522821576764,356,611,[[-0.08038137 -0.01191801 -0.00189057 -0.00220666 -1.44605852]],[-0.53745543]
305,HERO.JK,967,241,0.6887966804979253,311,656,[[-0.49394255  0.01302957  0.09089002  0.0019454  -1.73948807]],[-0.75333707]
306,HEXA.JK,967,241,0.6182572614107884,391,576,[[-0.01955616  0.01384712  0.00722326  0.01613419 -0.74808858]],[-0.38529634]
307,HILL.JK,8,2,0.0,7,1,[[0.02259604 0.18520273 0.17677649 0.23411636 0.01299958]],[1.79053199]
308,HITS.JK,967,241,0.6846473029045643,258,709,"[[-8.97958247e-01 -2.21640287e-04  5.58049956e-02 -2.09632440e-03
  -8.04010638e-01]]",[-1.00781674]
309,HKMU.JK,882,220,1.0,253,629,"[[-3.40755769e-02  2.15722091e-04  3.37313803e-02  2.16025630e-02
  -9.95179617e-01]]",[-0.90740167]
310,HMSP.JK,968,241,0.6307053941908713,371,597,[[-0.1345709   0.01245995 -0.02370903  0.00206966  0.36044055]],[-0.48397263]
311,HOKI.JK,968,241,0.7012448132780082,354,614,[[-0.20423797 -0.01969627 -0.00065297  0.00441665 -0.42523079]],[-0.54946907]
312,HOME.JK,966,241,1.0,114,852,[[ 0.09154675  0.127393    0.16935552 -0.04005168  0.88433768]],[-2.01562508]
313,HOMI.JK,495,123,0.6260162601626016,246,249,[[ 0.34583526 -0.04467941  0.31682153  0.02816369  1.23725947]],[-0.02245881]
314,HOPE.JK,360,90,0.9888888888888889,103,257,[[ 0.03938138 -0.00760647 -0.00110435 -0.00348744  0.43009099]],[-0.91156573]
315,HOTL.JK,966,241,1.0,155,811,[[-0.16939033  0.00568684 -0.00177882  0.0214257  -0.55922981]],[-1.65499013]
316,HRME.JK,776,194,0.7835051546391752,217,559,[[ 0.4041635   0.11560016 -0.00587094 -0.02992732  0.26972767]],[-0.95439254]
317,HRTA.JK,967,241,0.6556016597510373,351,616,[[-0.0873418   0.0220154   0.10367659  0.0060288  -0.96278819]],[-0.56019899]
318,HRUM.JK,968,241,0.5560165975103735,370,598,[[ 0.15771898  0.01547018  0.00458536  0.04984427 -0.04166963]],[-0.47955754]
319,IBFN.JK,966,241,1.0,245,721,[[ 0.1079486   0.00572319  0.04251006 -0.00904821 -0.44400649]],[-1.08008347]
320,IBOS.JK,177,44,0.5227272727272727,63,114,[[ 0.04930949  0.18398323 -0.20030354 -0.07506065  0.12925188]],[-0.59917111]
321,ICBP.JK,967,241,0.5435684647302904,420,547,[[-0.19669854 -0.00250984  0.05099523 -0.00218609 -1.17798554]],[-0.26170603]
322,ICON.JK,967,241,0.7551867219917012,304,663,"[[-5.12801894e-01 -4.47191331e-02 -1.83984286e-02 -1.54640338e-04
  -3.12922178e+00]]",[-0.79848833]
323,IDEA.JK,302,75,0.64,103,199,[[ 0.00759042  0.00653508  0.05323169 -0.04707958 -0.01219936]],[-0.65049592]
324,IDPR.JK,967,241,0.6182572614107884,269,698,[[-0.0975955   0.00333196 -0.11059399  0.00336755 -0.90541665]],[-0.95717829]
325,IFII.JK,640,159,0.5786163522012578,239,401,[[-0.11447784  0.00624748  0.03391357  0.02137407 -1.01073202]],[-0.5140774]
326,IFSH.JK,642,160,0.65625,201,441,"[[ 2.67238801e-02 -1.04440849e-01  3.92858270e-04 -4.62187362e-02
  -9.29501273e-01]]",[-0.79031491]
327,IGAR.JK,967,241,0.6556016597510373,365,602,[[-0.21017932  0.00448857 -0.05531278  0.00273705 -2.23896479]],[-0.49350648]
328,IIKP.JK,966,241,1.0,98,868,[[-0.35910205  0.19190589  1.57734431 -0.05226157  0.39459065]],[-2.16755779]
329,IKAI.JK,966,241,1.0,125,841,[[-0.28909194 -0.00107306  0.05310092 -0.01062144 -0.38847783]],[-1.91306164]
330,IKAN.JK,606,151,0.7284768211920529,193,413,[[ 0.2374539   0.0299642   0.04123145 -0.025702   -0.18095623]],[-0.76789249]
331,IKBI.JK,967,241,0.6514522821576764,268,699,"[[-3.70524198e-01  1.53247377e-04  2.78884761e-03  4.33717102e-03
  -2.26934240e+00]]",[-0.95740686]
332,IMAS.JK,967,241,0.5186721991701245,360,607,[[-0.08322751  0.00948697 -0.04071024 -0.00737945  0.17587555]],[-0.52342609]
333,IMJS.JK,967,241,0.5892116182572614,326,641,[[-0.2216635  -0.00582372 -0.00771231 -0.02313748 -0.12751563]],[-0.67721281]
334,IMPC.JK,967,241,0.6390041493775933,373,594,[[ 0.0122563  -0.0731683  -0.03186595 -0.00142851  0.07273195]],[-0.46103463]
335,INAF.JK,967,241,0.7012448132780082,350,617,[[0.39696753 0.01396222 0.14772269 0.0103318  0.52528511]],[-0.57446966]
336,INAI.JK,967,241,0.7261410788381742,343,624,[[-0.41274887 -0.00939028  0.01806371  0.0037719  -3.22153379]],[-0.59500596]
337,INCF.JK,967,241,0.7800829875518672,249,718,[[ 0.67071156  0.00441566 -0.01080124  0.00165296 -0.86979838]],[-1.05959294]
338,INCI.JK,967,241,0.6348547717842323,346,621,[[-0.56700734  0.03513664 -0.02680236 -0.00183908 -1.79778245]],[-0.57351932]
339,INCO.JK,967,241,0.5684647302904564,410,557,[[-0.02315906 -0.0177214  -0.02895543 -0.01152559  0.62194217]],[-0.30685103]
340,INDF.JK,967,241,0.5767634854771784,416,551,[[-0.27463465  0.00977332 -0.00310217  0.00061554  0.0601821 ]],[-0.28079085]
341,INDO.JK,624,155,0.6193548387096774,242,382,[[-0.03231971 -0.00394776  0.00951722  0.00076357 -0.33322779]],[-0.45692627]
342,INDR.JK,967,241,0.6348547717842323,367,600,[[-0.1375557  -0.04079243 -0.03144535 -0.01786076 -0.12780886]],[-0.48704144]
343,INDS.JK,967,241,0.6016597510373444,345,622,"[[-1.05992725e-01 -4.19860493e-04 -8.28296979e-02 -2.99197738e-05
  -1.63017363e+00]]",[-0.58668155]
344,INDX.JK,968,241,0.6970954356846473,283,685,[[-0.02378243 -0.00189551 -0.01457177 -0.00155396 -1.3234589 ]],[-0.87876818]
345,INDY.JK,967,241,0.5311203319502075,406,561,[[-0.06381154 -0.02563136 -0.00399744  0.02718695 -0.00799705]],[-0.32746865]
346,INKP.JK,967,241,0.5975103734439834,395,572,[[-0.39778826 -0.03331398  0.03466135 -0.01609498 -0.37214293]],[-0.37054689]
347,INOV.JK,727,181,0.6629834254143646,277,450,[[-0.28261501  0.0881815  -0.00701911  0.01074839 -1.35941986]],[-0.48337359]
348,INPC.JK,967,241,0.7385892116182573,251,716,"[[-4.92576232e-02  5.15611045e-03  1.27261659e-01 -4.66255689e-04
  -1.48485968e+00]]",[-1.04503662]
349,INPP.JK,967,241,0.6970954356846473,211,756,[[-0.81390153  0.00957803 -0.0203508   0.00274909 -1.67249522]],[-1.27533731]
350,INPS.JK,967,241,0.7551867219917012,266,701,[[ 0.97614099  0.02336555  0.03861189  0.01208211 -0.4127064 ]],[-0.96573807]
351,INRU.JK,968,241,0.6514522821576764,205,763,[[-0.20756378 -0.01478783 -0.01572188  0.00150578 -0.13110836]],[-1.31305318]
352,INTA.JK,967,241,0.966804979253112,260,707,[[-0.0166694   0.12958854 -0.05393837 -0.0079037  -0.97755827]],[-1.00310732]
353,INTD.JK,966,241,0.6970954356846473,298,668,[[-0.52746961 -0.00705401 -0.00130975  0.00748956 -0.66922666]],[-0.80859907]
354,INTP.JK,967,241,0.5560165975103735,428,539,"[[-8.32100718e-02  2.05414033e-02  5.76042284e-02 -1.10085800e-04
  -6.56823569e-01]]",[-0.22485488]
355,IPAC.JK,340,85,0.6470588235294118,113,227,[[ 0.23758171 -0.02590936 -0.00249832  0.00283157 -0.80031735]],[-0.68680109]
356,IPCC.JK,936,233,0.6223175965665236,348,588,[[-0.00847308  0.02247465  0.04732262 -0.00490714 -0.46688028]],[-0.52035004]
357,IPCM.JK,967,241,0.6721991701244814,356,611,[[ 0.17449867  0.01525245 -0.00336446 -0.00425754 -0.24717898]],[-0.53867356]
358,IPOL.JK,967,241,0.6390041493775933,336,631,[[-0.20492594 -0.00379499  0.03165838  0.00809239 -2.36632398]],[-0.62500606]
359,IPPE.JK,251,62,0.9354838709677419,86,165,[[ 0.31155683 -0.08147828  0.07773902 -0.04491622  0.1766819 ]],[-0.66911945]
360,IPTV.JK,728,182,0.7857142857142857,206,522,[[ 0.14734135 -0.04164784  0.0311067   0.00407727 -0.5317884 ]],[-0.93583537]
361,IRRA.JK,672,167,0.6646706586826348,265,407,[[-0.05876569 -0.07057317 -0.13188122  0.00598225  0.07052566]],[-0.43821245]
362,IRSX.JK,21,5,0.6,7,14,[[-0.02111993 -0.35748477 -0.25625452 -0.20546905 -0.10587217]],[-0.76536361]
363,ISAP.JK,54,13,0.6923076923076923,14,40,[[-0.0130702  -0.14660532  0.59514351  0.45306207  0.55280984]],[-1.04551612]
364,ISAT.JK,967,241,0.5477178423236515,392,575,[[-0.006601    0.01116528  0.0036742  -0.00255839  0.07886145]],[-0.38658861]
365,ISSP.JK,967,241,0.6390041493775933,356,611,"[[-3.64499370e-01  6.02524249e-04  3.21124688e-03 -1.01313425e-03
  -1.34024795e+00]]",[-0.53180267]
366,ITIC.JK,730,182,0.6098901098901099,282,448,[[ 0.35941747 -0.00221989  0.01169387  0.01184202 -0.24616724]],[-0.46385706]
367,ITMA.JK,968,241,0.6556016597510373,336,632,"[[-5.51909123e-01 -1.61437940e-02  9.45742987e-04 -7.97180299e-03
  -1.02020990e+00]]",[-0.63295116]
368,ITMG.JK,967,241,0.4979253112033195,443,524,[[ 0.10084756 -0.03475728  0.00749765 -0.00160311  0.37767307]],[-0.16877232]
369,JARR.JK,126,31,0.7419354838709677,34,92,[[-0.05381402  0.15759992  0.5372909   0.00515465  0.48952906]],[-1.0282239]
370,JAST.JK,757,189,0.6772486772486772,252,505,[[ 0.50978152 -0.05010185  0.1339341  -0.01319848  0.29881946]],[-0.7047878]
371,JAWA.JK,967,241,0.6597510373443983,278,689,[[-0.36450171 -0.00806501 -0.02063719  0.00565995 -1.16359538]],[-0.90371127]
372,JAYA.JK,805,201,0.6119402985074627,282,523,[[-0.44456965  0.1364127   0.09833101 -0.01079282 -0.78713302]],[-0.61453084]
373,JECC.JK,968,241,0.7634854771784232,98,870,[[-0.43975246  0.00508873  0.01079054  0.0042927  -0.01985494]],[-2.17996457]
374,JIHD.JK,968,241,0.6721991701244814,230,738,[[-0.32438184  0.01145776  0.01353192 -0.06850844 -1.70511473]],[-1.18822237]
375,JKON.JK,968,241,0.5850622406639004,196,772,[[-0.50746485  0.00197121 -0.04319098  0.00655046 -1.2101792 ]],[-1.3716239]
376,JKSW.JK,967,241,1.0,65,902,[[-0.26223516 -0.03542075  0.00656842  0.03246844 -1.90640214]],[-2.6642166]
377,JMAS.JK,967,241,0.7261410788381742,257,710,[[-0.70972828 -0.00343818  0.06388754  0.0172862  -1.9370285 ]],[-1.01599915]
378,JPFA.JK,968,241,0.5933609958506224,406,562,[[-0.15061662  0.006625   -0.00525445  0.00174973 -0.02196275]],[-0.3228558]
379,JRPT.JK,967,241,0.6721991701244814,316,651,[[ 0.04565888  0.0365577  -0.01728046  0.0389224  -1.01766146]],[-0.71787535]
380,JSKY.JK,967,241,0.9543568464730291,328,639,[[-0.00128255  0.04538174  0.06430883 -0.00090467 -0.31966422]],[-0.66933437]
381,JSMR.JK,967,241,0.6224066390041494,420,547,[[-0.0013537   0.00147208 -0.00526917  0.01764949  0.00045787]],[-0.26104954]
382,JSPT.JK,967,241,0.8423236514522822,106,861,"[[-2.03523743e-01  5.07700456e-03  5.34596447e-02 -1.65538660e-03
  -1.72073575e+00]]",[-2.1075753]
383,JTPE.JK,968,241,0.7344398340248963,296,672,[[ 0.46257578  0.00295939 -0.28588718  0.02470228  0.66624747]],[-0.84530197]
384,KAEF.JK,967,241,0.6970954356846473,341,626,[[ 0.10427574 -0.05026026 -0.0087568   0.00486189 -0.03926986]],[-0.60730828]
385,KARW.JK,967,241,0.7095435684647303,291,676,[[-0.20827898 -0.01083095 -0.08747107 -0.00152017 -1.26469319]],[-0.83644467]
386,KAYU.JK,730,182,0.9340659340659341,169,561,[[-0.64098879  0.06774727 -0.01230257  0.00637921 -0.29139906]],[-1.20844204]
387,KBAG.JK,575,143,1.0,73,502,[[-0.00273765  0.19987393  0.75858432 -0.01878074 -0.21007548]],[-1.92198525]
388,KBLI.JK,968,241,0.6639004149377593,326,642,[[-0.25921311  0.01359981 -0.0847818  -0.00158839 -1.13108139]],[-0.67388539]
389,KBLM.JK,967,241,0.6265560165975104,363,604,"[[-5.75820032e-01 -8.75617393e-04 -1.33364573e-02 -1.75572119e-02
  -2.91377138e+00]]",[-0.50549531]
390,KBLV.JK,967,241,0.6846473029045643,263,704,[[-0.37843703 -0.00839338 -0.03461669 -0.00143613  0.00451269]],[-0.99379095]
391,KDSI.JK,967,241,0.6348547717842323,363,604,[[-0.22362553 -0.00246966 -0.00548762 -0.00356042 -1.52209152]],[-0.50718476]
392,KDTN.JK,72,17,0.5294117647058824,25,47,[[-0.03486145  0.95799962  0.41552384  0.02088862 -0.26952945]],[-0.60049742]
393,KEEN.JK,696,174,0.6091954022988506,272,424,[[-0.17913577  0.00782128  0.19298414  0.0329091  -1.56536481]],[-0.44494917]
394,KEJU.JK,648,162,0.6666666666666666,248,400,[[-0.02114832 -0.01528567 -0.10093348 -0.00697997 -1.24457291]],[-0.47829277]
395,KETR.JK,71,17,0.5882352941176471,19,52,[[-0.06104836 -0.07451926 -0.51153177  0.21479738 -0.38462314]],[-0.95263376]
396,KICI.JK,968,241,0.6307053941908713,280,688,[[-0.53237801 -0.0275436   0.00214358  0.00570749  0.14298444]],[-0.90456624]
397,KIJA.JK,968,241,0.8589211618257261,304,664,[[-0.05539286 -0.10295341  0.00359998  0.02455265 -0.50796821]],[-0.78600431]
398,KING.JK,16,3,0.6666666666666666,10,6,[[-0.03879261 -0.11982518 -0.06693309 -0.37378144  0.02025208]],[0.52132157]
399,KINO.JK,967,241,0.6265560165975104,370,597,[[ 0.14766128 -0.02931146 -0.00268304  0.03249677  0.45215717]],[-0.48343807]
400,KIOS.JK,967,241,0.6224066390041494,271,696,[[ 0.20671312 -0.01789225  0.00537679 -0.05939991 -0.26090521]],[-0.93930498]
401,KJEN.JK,732,183,0.6721311475409836,163,569,[[ 0.35169575  0.04443425  0.11560351 -0.0139224  -0.04353764]],[-1.24890573]
402,KKES.JK,124,31,0.6451612903225806,47,77,[[-0.05639227  0.4026837   0.41253506  0.05838671 -0.36938731]],[-0.49529934]
403,KKGI.JK,967,241,0.5809128630705395,387,580,[[-0.07462094  0.02631938  0.02569564 -0.00190745 -1.15786383]],[-0.4045531]
404,KLBF.JK,968,241,0.5477178423236515,415,553,"[[-4.18791252e-02  1.62863753e-02 -3.88150775e-02 -4.17385755e-04
  -1.28201953e+00]]",[-0.28121047]
405,KLIN.JK,124,30,0.4666666666666667,20,104,[[-0.08884441  0.60526506  0.25347688 -0.26688521 -0.78472937]],[-1.69158896]
406,KMDS.JK,497,124,0.6451612903225806,204,293,[[-0.17849181  0.13899185 -0.04300584 -0.02445523 -1.950748  ]],[-0.36051711]
407,KMTR.JK,967,241,0.6804979253112033,341,626,[[-0.14314771 -0.03229926 -0.03193022 -0.00514103 -0.68114325]],[-0.60129311]
408,KOBX.JK,967,241,0.6141078838174274,375,592,[[-0.34897078  0.03038296  0.00523161 -0.00646457 -1.65301868]],[-0.44878207]
409,KOIN.JK,967,241,0.7053941908713693,199,768,[[-0.42268903 -0.03830236  0.1036471   0.0343751  -0.50054344]],[-1.34783129]
410,KONI.JK,967,241,0.6804979253112033,231,736,[[ 0.90129379  0.02188092  0.01994623 -0.00309158  0.10678275]],[-1.16878087]
411,KOPI.JK,967,241,0.6970954356846473,260,707,[[-0.29898202  0.0049364  -0.01404147 -0.00569915 -1.00801024]],[-0.99835933]
412,KOTA.JK,728,181,1.0,204,524,[[ 0.61503961  0.14538074 -0.0244922  -0.02779086  0.68995407]],[-0.95469899]
413,KPAL.JK,951,237,1.0,191,760,[[ 0.01140337  0.1679231   0.14615299 -0.02845094 -0.5030118 ]],[-1.37117245]
414,KPAS.JK,884,220,1.0,163,721,[[-0.18626153  0.03794829  0.08212894  0.0109073  -0.37859193]],[-1.49586694]
415,KPIG.JK,967,241,0.7219917012448133,273,694,[[-0.27671276  0.03783522 -0.12353793  0.00299686 -0.710674  ]],[-0.93158345]
416,KRAH.JK,966,241,1.0,140,826,[[ 0.12535233  0.12390153 -0.0884725   0.22965289  0.38589358]],[-1.79811274]
417,KRAS.JK,967,241,0.6597510373443983,362,605,[[ 0.04454786  0.01960165 -0.00631081 -0.0112075  -0.10557972]],[-0.51616444]
418,KREN.JK,967,241,0.970954356846473,309,658,[[ 0.03684515 -0.06349161  0.00706083  0.00037044  0.31129256]],[-0.76551894]
419,KRYA.JK,132,32,0.6875,42,90,[[ 0.205214   -1.42650383  0.54960882 -0.1646022   0.74586996]],[-0.86359886]
420,KUAS.JK,277,69,0.782608695652174,90,187,[[ 0.03027818  0.10775848  0.00994855 -0.07097603 -1.16709766]],[-0.74039967]
421,LABA.JK,352,87,0.7011494252873564,115,237,[[ 0.44418952  0.07717131  0.02841175 -0.06996388 -0.40070876]],[-0.7202238]
422,LAJU.JK,27,6,0.8333333333333334,11,16,[[-0.01555705  0.74214387  0.43509473 -0.15923533  0.20436667]],[-0.34429924]
423,LAND.JK,909,227,0.8678414096916299,318,591,[[-0.44827032  0.20120574 -0.0335364  -0.03553843  0.27282118]],[-0.61908508]
424,LCKM.JK,967,241,0.6846473029045643,245,722,[[-0.53887927  0.0030809   0.01824139  0.0042769  -2.37861254]],[-1.09172854]
425,LEAD.JK,967,241,0.5975103734439834,116,851,"[[ 9.54814422e-15 -1.33678072e-09 -1.99872458e-10  2.25949218e-09
   2.74485799e-14]]",[-1.42557292e-10]
426,LFLO.JK,384,96,0.6875,136,248,[[0.01167414 0.05064581 0.14823348 0.04104062 0.31962462]],[-0.58514085]
427,LIFE.JK,728,181,0.8839779005524862,111,617,[[ 0.00436716  0.07436156 -0.00096665 -0.0501578  -0.24691912]],[-1.7060935]
428,LINK.JK,967,241,0.6224066390041494,388,579,[[-0.16748663 -0.01411536 -0.00300689  0.00640911 -0.25378207]],[-0.39544628]
429,LION.JK,968,241,0.6307053941908713,258,710,[[-0.49691123 -0.00762973 -0.0016619  -0.02835542 -1.2597271 ]],[-1.01346605]
430,LMAS.JK,966,241,1.0,178,788,[[-0.25365558  0.01588132  0.02110614 -0.01719729 -1.24672256]],[-1.49199654]
431,LMPI.JK,968,241,0.6763485477178424,319,649,"[[-6.11787229e-01  2.38745203e-03 -3.04705525e-02  2.84147946e-04
  -2.58964626e+00]]",[-0.71246954]
432,LMSH.JK,968,241,0.6763485477178424,221,747,[[ 0.15476008 -0.03633812  0.0181497   0.00725228 -0.05481553]],[-1.22128546]
433,LPCK.JK,968,241,0.6224066390041494,393,575,[[ 0.28617042 -0.0160033  -0.01143095  0.0057157   0.1269716 ]],[-0.37734075]
434,LPGI.JK,968,241,0.6307053941908713,196,772,[[ 0.05472226  0.02387769  0.01444851 -0.02537462 -0.61551721]],[-1.36950039]
435,LPIN.JK,967,241,0.6473029045643154,306,661,[[ 0.14096058 -0.04509287 -0.020411   -0.01077129 -1.13116639]],[-0.76650895]
436,LPKR.JK,968,241,0.6721991701244814,340,628,[[-0.03945215 -0.00800802  0.016976    0.00198836 -0.18175887]],[-0.61575045]
437,LPLI.JK,968,241,0.6348547717842323,299,669,[[-0.43188982 -0.01415292  0.0880881  -0.01656292 -1.45722415]],[-0.80749939]
438,LPPF.JK,967,241,0.5643153526970954,409,558,"[[ 2.38935549e-01  4.29079340e-02 -2.98619118e-03  2.88009733e-04
   6.26566301e-01]]",[-0.31440847]
439,LPPS.JK,968,241,0.7053941908713693,308,660,"[[-3.64469723e-01 -8.48071514e-03 -5.59184857e-02  1.08190258e-03
  -2.07897811e+00]]",[-0.75293482]
440,LRNA.JK,967,241,0.7012448132780082,307,660,"[[-4.88838809e-01 -2.75958086e-06 -1.56699006e-02 -2.07159068e-02
  -2.45385740e+00]]",[-0.76854506]
441,LSIP.JK,967,241,0.6307053941908713,413,554,[[-0.00924417  0.00730951 -0.02428165  0.00521327 -0.04052614]],[-0.29272443]
442,LTLS.JK,967,241,0.6307053941908713,354,613,[[-0.19132185 -0.07706035 -0.00107366  0.0067223  -0.89180226]],[-0.55880688]
443,LUCK.JK,854,213,0.7183098591549296,301,553,[[ 0.27915056 -0.01027014 -0.01807009 -0.01708173 -0.9695772 ]],[-0.60075858]
444,LUCY.JK,368,92,0.5869565217391305,147,221,[[ 0.28086194 -0.0529544  -0.00118081 -0.03915156  0.71671027]],[-0.4293034]
445,MABA.JK,966,241,1.0,53,913,[[-0.48073623  0.25222806  1.01851538  0.07340532  0.85359482]],[-2.82020856]
446,MAIN.JK,967,241,0.6721991701244814,390,577,[[-0.13158935 -0.01332045 -0.03985689 -0.00409726 -0.72398678]],[-0.39046045]
447,MAMI.JK,967,241,1.0,164,803,[[ 1.01302693  0.31077175 -0.14458531  0.0117116   1.00564599]],[-1.6043645]
448,MAPA.JK,937,234,0.5427350427350427,318,619,[[-0.00015557  0.00241904  0.00082269  0.00141696 -0.00489072]],[-0.66876614]
449,MAPB.JK,967,241,0.6141078838174274,263,704,"[[-1.27084142e-01  1.17882174e-04 -7.52037870e-04 -1.75819271e-03
  -1.95251745e+00]]",[-0.98570749]
450,MAPI.JK,967,241,0.5228215767634855,382,585,[[-0.39368924  0.00506085 -0.02510745 -0.00365114 -0.07020485]],[-0.42905455]
451,MARI.JK,967,241,0.6265560165975104,316,651,[[ 0.21643961  0.02538125 -0.00450501 -0.00151719  0.04450232]],[-0.72219638]
452,MARK.JK,967,241,0.6182572614107884,392,575,[[ 0.08791086  0.00518495 -0.03929932  0.00889689 -0.18044124]],[-0.38242143]
453,MASA.JK,967,241,0.6390041493775933,305,662,[[ 0.24081041 -0.00757831  0.03407343  0.0192086   0.09714982]],[-0.77893965]
454,MASB.JK,340,85,0.7411764705882353,92,248,[[-0.04105391 -0.03804335 -0.07644203  0.0652401  -2.28185883]],[-1.00330544]
455,MAYA.JK,968,241,0.6721991701244814,175,793,[[0.47138609 0.0479829  0.06746709 0.08497568 0.04327814]],[-1.52882845]
456,MBAP.JK,967,241,0.5643153526970954,418,549,[[ 0.0001283   0.00252062 -0.00132117 -0.00314561 -0.00130939]],[-0.27005597]
457,MBSS.JK,967,241,0.6348547717842323,362,605,[[-0.21283789 -0.00505588 -0.00669012 -0.04055353 -0.25368996]],[-0.51647347]
458,MBTO.JK,967,241,0.6265560165975104,348,619,"[[-9.78267095e-01  4.48200779e-02  4.50758597e-02  1.97665768e-03
  -2.59359123e+00]]",[-0.57539466]
459,MCAS.JK,967,241,0.6141078838174274,414,553,[[ 0.63270895 -0.01645719  0.00472197 -0.02495051  1.51317586]],[-0.30093817]
460,MCOL.JK,304,75,0.6133333333333333,141,163,"[[ 4.01808481e-02 -2.67714039e-04  7.58873083e-02  6.16725656e-03
  -3.90255481e-01]]",[-0.13358654]
461,MCOR.JK,967,241,0.7219917012448133,307,660,[[-0.25636461  0.02075595  0.04223098  0.00548594  0.20248804]],[-0.76762391]
462,MDIA.JK,966,241,0.9336099585062241,202,764,[[-0.57990208 -0.00338641 -0.01124013 -0.01624075 -1.40094618]],[-1.33250189]
463,MDKA.JK,968,241,0.5933609958506224,431,537,[[-0.26809351  0.02215724 -0.00050021 -0.00637545 -0.36057278]],[-0.22299302]
464,MDKI.JK,967,241,0.6514522821576764,346,621,[[-0.35448648  0.03551277  0.04414064 -0.00354513 -2.41563791]],[-0.58596782]
465,MDLN.JK,967,241,0.6514522821576764,201,766,[[ 0.10824664 -0.03772553  0.08036865  0.0081895  -0.91561557]],[-1.34459129]
466,MEDC.JK,968,241,0.5228215767634855,375,593,[[ 0.0233681   0.08931099  0.00501616  0.03644719 -0.82278236]],[-0.4550127]
467,MEDS.JK,123,30,0.6333333333333333,46,77,[[-0.01928517  0.25111237 -0.40595375  0.18277845  0.60704713]],[-0.46633178]
468,MEGA.JK,968,241,0.6182572614107884,227,741,"[[-2.89348930e-01 -3.17358650e-02  9.81077866e-05  2.49156494e-03
   1.41216961e-02]]",[-1.18479925]
469,MERK.JK,967,241,0.5435684647302904,338,629,[[ 0.05930998  0.03159449 -0.03559258  0.01519366 -0.38852699]],[-0.62379379]
470,META.JK,967,241,0.6597510373443983,322,645,"[[ 1.08050347e-01  1.18965724e-01  1.65465640e-02  4.24041765e-05
  -8.30514013e-01]]",[-0.69128005]
471,MFIN.JK,967,241,0.6431535269709544,294,673,[[-0.11565885  0.04261227 -0.01923619 -0.02058631 -2.30551477]],[-0.83105776]
472,MFMI.JK,967,241,0.6431535269709544,322,645,[[-0.0823128   0.01940853  0.0343923   0.00798474 -1.54128094]],[-0.69355711]
473,MGLV.JK,353,88,0.75,142,211,[[-0.01434509  0.03064835 -0.03038253  0.00192333  0.74263944]],[-0.40186373]
474,MGNA.JK,968,241,1.0,9,959,[[-0.00610014  0.02143787 -0.73635014 -0.1663559  -0.15892931]],[-4.71667472]
475,MGRO.JK,933,233,0.6051502145922747,330,603,[[ 0.19937587 -0.02314556 -0.01006808  0.009406    1.11404429]],[-0.61363512]
476,MICE.JK,967,241,0.5643153526970954,334,633,[[-0.29058604  0.05102057 -0.01631247  0.01788606 -1.92936341]],[-0.63665699]
477,MIDI.JK,968,241,0.6016597510373444,183,785,"[[-2.80277747e-01  4.98890300e-03 -8.72876721e-02  5.69179113e-04
  -7.76071047e-01]]",[-1.45594852]
478,MIKA.JK,967,241,0.5809128630705395,438,529,[[-0.04266575 -0.01258658 -0.0752418   0.01285661 -0.69292941]],[-0.18656616]
479,MINA.JK,967,241,0.8630705394190872,199,768,[[ 0.06427154  0.00446961  0.00594839  0.00312774 -0.00937062]],[-1.35486856]
480,MKNT.JK,966,241,1.0,107,859,[[-0.52128651  0.39091476 -0.04371165  0.03315453 -1.82755652]],[-2.09437681]
481,MKPI.JK,967,241,0.7344398340248963,81,886,"[[-1.01603992e-04 -2.24828200e-03 -1.28359580e-01 -1.14313397e-02
  -2.11242245e-07]]",[-2.41877191]
482,MKTR.JK,72,18,0.5555555555555556,29,43,[[ 0.03886227  0.04075622  0.23274483 -0.00449922  0.16197336]],[-0.4149403]
483,MLBI.JK,967,241,0.6307053941908713,279,688,[[ 0.11912836  0.02159104 -0.00740171  0.04110346 -0.31604592]],[-0.9000419]
484,MLIA.JK,968,241,0.6348547717842323,391,577,[[ 0.01884417  0.00347387 -0.09016253  0.00447748  0.53652726]],[-0.39650998]
485,MLPL.JK,967,241,0.6431535269709544,291,676,[[ 0.04851278  0.00850919 -0.02068302 -0.00938031 -0.67282381]],[-0.83862884]
486,MLPT.JK,968,241,0.6099585062240664,311,657,[[ 0.2412756   0.00073018  0.0008449  -0.00560289 -0.04751079]],[-0.7494906]
487,MMIX.JK,56,14,0.42857142857142855,22,34,[[ 0.09535173  0.06344319  0.2253519  -0.0480043   0.11663811]],[-0.4433945]
488,MMLP.JK,967,241,0.6141078838174274,342,625,[[-0.32582778 -0.01608763  0.03215433 -0.00387747 -1.3123404 ]],[-0.59717406]
489,MNCN.JK,967,241,0.6473029045643154,359,608,[[ 0.04207033 -0.00363072  0.0243905   0.00604303 -0.55485718]],[-0.52032936]
490,MOLI.JK,905,226,0.6150442477876106,260,645,[[-0.52716481 -0.0522565  -0.03227046  0.002354   -0.89349921]],[-0.90359725]
491,MORA.JK,124,31,0.6129032258064516,37,87,[[-0.04028919 -0.05677712  0.41003443 -0.00560821  0.42581853]],[-0.79248468]
492,MPMX.JK,967,241,0.6348547717842323,363,604,[[-0.09924029 -0.00539468  0.07180329  0.00028622 -0.13390015]],[-0.50945208]
493,MPOW.JK,967,241,0.6929460580912863,334,633,[[-0.32994704  0.10560973 -0.01026496  0.0039818  -1.1648716 ]],[-0.63775939]
494,MPPA.JK,968,241,0.6390041493775933,342,626,[[ 0.14638426  0.0399486  -0.0026544  -0.00316583  0.46740772]],[-0.60912375]
495,MPRO.JK,882,220,0.7272727272727273,233,649,[[-0.27537363 -0.00389976  0.06799069  0.04750179  0.04977136]],[-1.02493914]
496,MRAT.JK,967,241,0.6016597510373444,332,635,[[-0.44884764 -0.01139278 -0.01565396  0.00994364 -1.74436341]],[-0.64776029]
497,MREI.JK,967,241,0.6265560165975104,206,761,[[-0.7693224  -0.0277206   0.01647903  0.00200806 -0.58723308]],[-1.29982512]
498,MSIN.JK,952,238,0.6932773109243697,343,609,[[ 0.83961895  0.03749788 -0.08961099  0.00366774 -0.04849185]],[-0.58083307]
499,MSKY.JK,967,241,0.6680497925311203,274,693,"[[-2.78953761e-01 -9.76718137e-03  7.41865449e-02  2.24788875e-04
  -1.34232248e+00]]",[-0.9263644]
500,MTDL.JK,968,241,0.6556016597510373,410,558,[[-0.34994145  0.02530015  0.00154666  0.00750923 -0.09818079]],[-0.30880531]
501,MTEL.JK,261,65,0.676923076923077,92,169,[[-0.01205017 -0.00869595  0.16866586  0.13490593  0.09801855]],[-0.60338568]
502,MTLA.JK,967,241,0.6390041493775933,291,676,[[-0.33565309  0.02457546  0.00931113 -0.01472628 -1.86688556]],[-0.84324978]
503,MTMH.JK,180,44,0.5681818181818182,53,127,[[-0.00633223 -0.64579156 -0.13196988  0.01388211  0.38302509]],[-0.91105632]
504,MTPS.JK,777,194,0.8402061855670103,237,540,[[ 0.47739692 -0.02155943  0.2009828   0.01459053  0.05488483]],[-0.83624257]
505,MTRA.JK,966,241,1.0,111,855,[[-0.1359446  -0.09621969 -0.0059471  -0.01143857  0.03553432]],[-2.06060745]
506,MTSM.JK,967,241,0.6390041493775933,259,708,[[-0.76595722 -0.02069102  0.00114849  0.01852554 -0.72141994]],[-1.00230872]
507,MTWI.JK,967,241,0.6639004149377593,324,643,[[-0.13460591 -0.02104292  0.01613171 -0.00623052 -1.30509246]],[-0.69138971]
508,MYOH.JK,967,241,0.7302904564315352,353,614,[[-0.13799596 -0.01030455 -0.02316655  0.02425833 -0.90834675]],[-0.55362283]
509,MYOR.JK,968,241,0.5518672199170125,343,625,[[-0.01748305  0.00435032 -0.02477547 -0.00062953  0.50747855]],[-0.60264319]
510,MYRX.JK,967,241,1.0,104,863,[[-0.10643708 -0.00537836  0.63329391  0.00307458 -1.75050784]],[-2.12062241]
511,MYTX.JK,967,241,0.6804979253112033,277,690,"[[-6.86391371e-01  3.21703774e-02 -7.23463684e-02 -1.42479210e-03
  -2.91497743e+00]]",[-0.92524142]
512,NANO.JK,202,50,0.74,46,156,[[ 0.03650699 -0.04836302  0.43326544  0.17953033  0.07783969]],[-1.20800466]
513,NASA.JK,967,241,1.0,169,798,[[-0.1533567  -0.06930718  0.00519928  0.00753819  0.27783179]],[-1.56263012]
514,NASI.JK,249,62,0.7741935483870968,92,157,[[-0.07122187 -0.08814754 -0.24502814  0.01741223  0.57392534]],[-0.53961368]
515,NATO.JK,824,206,0.6262135922330098,306,518,"[[ 7.72124955e-02  1.18609563e-03  1.08091507e-02 -5.83104060e-03
   1.47413968e+00]]",[-0.54290165]
516,NAYZ.JK,22,5,0.6,12,10,[[-0.04192233  0.44635889  0.00638739  0.22072023  0.08543207]],[0.14411168]
517,NELY.JK,967,241,0.6556016597510373,334,633,[[-0.37508401  0.01579669  0.10976939 -0.00200228 -1.51009929]],[-0.6348286]
518,NETV.JK,224,56,0.6964285714285714,72,152,[[-0.09710176  0.54052055  0.00775253 -0.00657869 -1.07079066]],[-0.7314164]
519,NFCX.JK,933,233,0.6566523605150214,348,585,"[[ 9.62493050e-01  8.74312089e-03  2.99640133e-02 -5.96223816e-04
   8.82402277e-01]]",[-0.52747675]
520,NICK.JK,967,241,0.5477178423236515,312,655,[[-0.86264596  0.00194115 -0.00233641 -0.00272898 -1.72628343]],[-0.73532437]
521,NICL.JK,335,83,0.5903614457831325,111,224,[[-0.04686028  0.11417477  0.00509119 -0.04291767 -1.25941627]],[-0.70483528]
522,NIKL.JK,967,241,0.6721991701244814,355,612,[[ 0.32928074 -0.23078232  0.00482068 -0.00895362  0.10543701]],[-0.54672353]
523,NINE.JK,57,14,0.7857142857142857,10,47,[[-0.00430781  0.45025122 -0.02798565 -0.0654614   0.85608576]],[-1.6001517]
524,NIRO.JK,967,241,0.7136929460580913,237,730,"[[-3.54850489e-01 -3.42226368e-04 -1.61308108e-02  6.57016292e-04
  -2.57127277e+00]]",[-1.13258925]
525,NISP.JK,967,241,0.6141078838174274,309,658,"[[-5.44906789e-02 -2.85916495e-02 -4.00374608e-02 -3.59507037e-04
  -1.68193758e+00]]",[-0.76301322]
526,NOBU.JK,968,241,0.6514522821576764,239,729,[[-0.50694951  0.00295729  0.0460387   0.00133336 -0.14421377]],[-1.1145291]
527,NPGF.JK,380,95,0.8842105263157894,109,271,[[ 0.00345364 -0.00956383 -0.12808323  0.03700271  0.08160968]],[-0.93426866]
528,NRCA.JK,967,241,0.5933609958506224,366,601,"[[-4.44205578e-02  2.15494117e-02  5.49075111e-03 -8.06096880e-04
  -1.17745639e+00]]",[-0.48867512]
529,NTBK.JK,217,54,0.9629629629629629,10,207,[[-0.05959933 -0.2283705   0.07292025  0.03316852 -0.1653245 ]],[-3.10094886]
530,NUSA.JK,932,233,1.0,99,833,"[[4.82426116e-01 1.50646146e+00 1.56778442e-01 1.11068690e-03
  4.29147067e-01]]",[-2.1492662]
531,NZIA.JK,683,170,0.6411764705882353,239,444,[[ 0.14050676  0.01294336  0.03774587 -0.00970994 -0.64549411]],[-0.61549807]
532,OASA.JK,967,241,0.5850622406639004,262,705,[[ 0.11474011  0.00359297  0.10009014 -0.00687523 -0.97327791]],[-0.98464462]
533,OBMD.JK,252,62,0.5645161290322581,95,157,[[ 0.23339994  0.47513629 -0.08520782 -0.09523032 -0.13671796]],[-0.53993531]
534,OILS.JK,304,76,0.631578947368421,99,205,[[-0.15628843 -0.15799266 -0.08007764 -0.01186527 -0.32723737]],[-0.74249535]
535,OKAS.JK,967,241,0.6514522821576764,318,649,[[-0.17799224  0.0473208  -0.03566477 -0.00498526 -0.22912784]],[-0.72531938]
536,OLIV.JK,170,42,0.7857142857142857,40,130,[[-0.10810878  0.13565346 -0.19144184 -0.05505414  0.56975811]],[-1.23182674]
537,OMED.JK,72,18,0.7222222222222222,27,45,[[-0.01781188  0.41535544  0.45524462  0.11781149  0.08671227]],[-0.48002786]
538,OPMS.JK,684,171,0.7368421052631579,256,428,[[ 0.05660527  0.10379012  0.10366051 -0.01086781  0.38265408]],[-0.52896453]
539,PACK.JK,20,5,0.4,10,10,[[-0.02595946 -0.1313916  -0.19315255 -0.11475866 -0.04750678]],[0.08982586]
540,PADA.JK,55,13,0.5384615384615384,18,37,[[-0.03352115 -0.48357966  0.05288723 -0.1979013   0.20587026]],[-0.73136974]
541,PADI.JK,966,241,1.0,130,836,[[-0.13111418  0.05840471 -0.1339339  -0.01366989 -0.09154067]],[-1.87037264]
542,PALM.JK,968,241,0.6431535269709544,348,620,"[[-3.08360650e-01 -7.74901394e-03 -4.08478864e-03 -6.80641685e-04
  -1.45437759e+00]]",[-0.57479356]
543,PAMG.JK,729,182,0.7307692307692307,248,481,[[ 0.20953911 -0.00128336  0.02837614  0.0150288  -0.75326   ]],[-0.6589293]
544,PANI.JK,895,223,0.6053811659192825,318,577,"[[ 3.64061181e-01 -7.57433871e-03 -7.69963320e-03  8.23929702e-04
  -1.64344379e+00]]",[-0.59729985]
545,PANR.JK,967,241,0.5726141078838174,357,610,[[ 0.03409176  0.02287805  0.13161343  0.00054713 -0.23276835]],[-0.53963576]
546,PANS.JK,967,241,0.5518672199170125,370,597,"[[ 7.71562866e-02  3.08231106e-02 -1.19543473e-01 -3.27819655e-04
  -1.22749887e+00]]",[-0.47933289]
547,PBID.JK,967,241,0.6099585062240664,385,582,[[-0.05836978 -0.02232339 -0.02349035 -0.03633444 -2.15405114]],[-0.40872002]
548,PBRX.JK,967,241,0.7012448132780082,316,651,[[ 0.00412721 -0.00899935  0.04428487 -0.00387214 -0.07839403]],[-0.71944292]
549,PBSA.JK,968,241,0.6099585062240664,259,709,[[-0.17483399 -0.04466804 -0.06738579 -0.02712184 -0.04931385]],[-1.00903439]
550,PCAR.JK,967,241,0.7800829875518672,275,692,[[ 0.02349021  0.01812677  0.04438076 -0.01696015 -0.03470576]],[-0.91449662]
551,PDES.JK,968,241,0.7676348547717843,191,777,[[-0.01609969 -0.07720416 -0.01586436 -0.04706627  0.11754686]],[-1.42795648]
552,PDPP.JK,72,17,0.4117647058823529,30,42,[[-0.07172616 -0.22153488  0.04526678  0.02577085 -0.05270385]],[-0.39645026]
553,PEGE.JK,967,241,0.6514522821576764,292,675,[[ 0.26753421 -0.00351686 -0.03207015  0.05145581 -0.90919114]],[-0.83006589]
554,PEHA.JK,838,209,0.7081339712918661,298,540,[[-0.16791345  0.02394764  0.0064613  -0.00511511 -1.12304567]],[-0.59639391]
555,PEVE.JK,29,7,0.42857142857142855,11,18,[[-0.04128017  0.96510807  0.1490866   0.05863193 -0.33406368]],[-0.39238961]
556,PGAS.JK,967,241,0.5560165975103735,423,544,[[-0.16473027 -0.01079491  0.03778338 -0.0055046  -0.34043026]],[-0.25006117]
557,PGEO.JK,11,2,0.0,5,6,[[-0.0055523   0.11393352  0.089561   -0.06909309 -0.18097052]],[-0.36502904]
558,PGJO.JK,620,154,0.7077922077922078,210,410,[[ 0.33590388  0.2421643   0.02176334 -0.00187736 -0.36013082]],[-0.67690129]
559,PGLI.JK,967,241,0.6431535269709544,275,692,[[-0.47116903 -0.00437875 -0.02944961  0.00297236 -1.56850294]],[-0.91960165]
560,PGUN.JK,529,132,0.6363636363636364,170,359,[[-0.28901457 -0.06782122  0.00255157  0.03229339 -1.06714595]],[-0.74012368]
561,PICO.JK,967,241,0.6265560165975104,317,650,[[ 0.04717055 -0.02306114 -0.02433901 -0.01037269 -1.83844789]],[-0.71939674]
562,PJAA.JK,967,241,0.6680497925311203,284,683,[[-0.14165865 -0.03015177  0.00464397  0.00766868 -0.04197308]],[-0.87480126]
563,PKPK.JK,967,241,0.5352697095435685,248,719,[[-0.18685492 -0.02047824 -0.01278209  0.00911699 -0.84899163]],[-1.07269942]
564,PLAN.JK,492,123,0.7967479674796748,138,354,[[ 0.13083374  0.04093344 -0.00321654 -0.0064728  -0.63839264]],[-0.94994705]
565,PLIN.JK,968,241,0.6680497925311203,135,833,"[[-5.06129167e-01  2.28876495e-04  1.80126491e-01  1.14808902e-02
   2.22148218e-01]]",[-1.84349259]
566,PMJS.JK,635,158,0.6265822784810127,222,413,"[[-2.33958291e-01  1.60770539e-02 -1.66681057e-03  5.51799691e-03
  -1.95774140e+00]]",[-0.6224634]
567,PMMP.JK,441,110,0.7181818181818181,184,257,[[-0.14381237 -0.01588009 -0.08837204  0.00226797 -1.06531895]],[-0.33709279]
568,PNBN.JK,967,241,0.5643153526970954,368,599,[[-0.11289216 -0.01384506  0.01229418  0.0057985  -0.10369374]],[-0.48770427]
569,PNBS.JK,967,241,0.6556016597510373,213,754,[[-0.00887228  0.01724433 -0.04888749  0.0062861  -0.1341235 ]],[-1.28429777]
570,PNGO.JK,501,125,0.664,166,335,"[[-2.00012271e-01 -1.19880578e-02 -2.63829059e-04 -1.15625329e-02
  -1.87148449e+00]]",[-0.70094746]
571,PNIN.JK,967,241,0.5892116182572614,355,612,[[-0.14800131  0.03838876 -0.02092714 -0.00705181 -2.04348165]],[-0.5401134]
572,PNLF.JK,968,241,0.5850622406639004,352,616,[[-0.10702717  0.00465142  0.02476218 -0.00661112 -0.28206996]],[-0.55664284]
573,PNSE.JK,966,241,0.8630705394190872,150,816,[[ 0.19767532  0.03170479  0.04982554  0.02329645 -0.02004199]],[-1.69615721]
574,POLA.JK,860,215,0.7162790697674418,236,624,[[ 0.21356911  0.00490212 -0.0026593  -0.00586213 -1.14369888]],[-0.97074554]
575,POLI.JK,829,207,0.6714975845410628,310,519,[[-0.06429433  0.12532564 -0.0746     -0.00967728 -1.90636515]],[-0.52414401]
576,POLL.JK,934,233,0.721030042918455,319,615,[[ 0.97802745  0.01217951 -0.0133686   0.02696414  0.42026762]],[-0.6627722]
577,POLU.JK,735,183,0.639344262295082,212,523,"[[-6.28108558e-01  2.73325425e-04 -1.07113918e-01 -8.25421465e-03
   7.34073422e-02]]",[-0.92055096]
578,POLY.JK,968,241,0.7427385892116183,243,725,[[-0.38367442  0.0025637   0.03482949  0.00396011 -1.84264981]],[-1.09383699]
579,POOL.JK,966,241,1.0,150,816,[[-0.35739929 -0.04085145  0.72417477  0.02846439  0.18819325]],[-1.69295637]
580,PORT.JK,967,241,0.6804979253112033,188,779,[[-1.00789021  0.00279498 -0.003412    0.01551661 -0.15168544]],[-1.4232725]
581,POSA.JK,760,189,1.0,17,743,[[-0.15821681  1.36445715  0.83559739 -0.81039348  1.10002514]],[-3.80384728]
582,POWR.JK,967,241,0.6639004149377593,290,677,[[-0.02206882  0.02885069  0.05913341 -0.00438528 -1.1457582 ]],[-0.84553396]
583,PPGL.JK,522,130,0.5846153846153846,183,339,[[ 0.10143671 -0.00372509 -0.06546607  0.06958078  0.31300897]],[-0.62953972]
584,PPRE.JK,967,241,0.6639004149377593,339,628,[[ 0.00021858  0.06118998 -0.05628536  0.00022018 -0.01085636]],[-0.61567884]
585,PPRO.JK,967,241,0.9294605809128631,250,717,[[-0.05187909 -0.00488198  0.0863285   0.0021588  -0.15640033]],[-1.04636157]
586,PRAS.JK,967,241,0.7219917012448133,271,696,[[-0.26667491  0.00260979  0.02079832  0.00489543 -1.41759151]],[-0.94168131]
587,PRAY.JK,72,18,0.7777777777777778,27,45,[[ 0.01206533 -0.00603988 -0.06835357 -0.11498256 -0.2871387 ]],[-0.54788147]
588,PRDA.JK,967,241,0.6141078838174274,352,615,[[ 0.02899532 -0.00341173  0.02518817  0.00645573 -1.30363881]],[-0.55628479]
589,PRIM.JK,965,241,0.7178423236514523,302,663,[[-0.12711005  0.00291248 -0.00321228 -0.00502223 -0.62213015]],[-0.78267238]
590,PSAB.JK,967,241,0.6058091286307054,350,617,[[-0.17026081  0.10734611 -0.00167961 -0.00640914 -0.3880207 ]],[-0.57413635]
591,PSDN.JK,968,241,0.6514522821576764,311,657,[[-0.56313144 -0.00254454 -0.04662668 -0.00821301 -1.05758758]],[-0.74671143]
592,PSGO.JK,648,162,0.6296296296296297,250,398,[[-0.20609314  0.01352713 -0.02985914 -0.0075982  -0.74770743]],[-0.47336122]
593,PSSI.JK,967,241,0.6099585062240664,399,568,[[-0.17392532  0.03499982 -0.01686638  0.01455144 -0.58944474]],[-0.33773411]
594,PTBA.JK,967,241,0.5560165975103735,424,543,[[ 0.02593917 -0.03706127 -0.16720033  0.01271495 -0.5319404 ]],[-0.24568785]
595,PTDU.JK,447,111,0.8378378378378378,139,308,[[ 0.82684026  0.04512329 -0.00781414  0.00767355  0.50427414]],[-0.79717691]
596,PTIS.JK,968,241,0.6390041493775933,209,759,[[-0.32139473 -0.01209321  0.06079192  0.00490249 -1.01332093]],[-1.28699916]
597,PTMP.JK,6,1,0.0,2,4,[[-0.01204557 -0.18262244 -0.04465459 -0.4397565  -0.09823066]],[-1.49797149]
598,PTPP.JK,967,241,0.6058091286307054,384,583,[[ 0.11366252 -0.07270527  0.07949279  0.01159855  0.33689004]],[-0.42099885]
599,PTPW.JK,608,152,0.6578947368421053,227,381,[[ 0.23691564  0.01333188 -0.22243914  0.01884361  0.66833037]],[-0.53607842]
600,PTRO.JK,967,241,0.5228215767634855,417,550,[[-0.1314467  -0.00087865 -0.03778117 -0.01016721 -0.3724286 ]],[-0.27193412]
601,PTSN.JK,968,241,0.6514522821576764,341,627,[[-0.0452264  -0.03003435 -0.00434545 -0.00756375 -0.90643749]],[-0.60653234]
602,PUDP.JK,968,241,0.6473029045643154,205,763,"[[-3.08234913e-01 -4.17857361e-03  1.53606491e-02 -1.20290623e-03
  -1.34949733e+00]]",[-1.31301698]
603,PURA.JK,614,153,1.0,164,450,[[ 0.00870911  0.00481784 -0.00939111 -0.00829693  0.38696739]],[-1.01299986]
604,PURE.JK,674,168,1.0,191,483,[[-0.3564144  -0.03240998 -0.05660302  0.00863381 -0.73376888]],[-0.93599192]
605,PURI.JK,496,124,0.6532258064516129,165,331,"[[-5.20049813e-01  2.44934919e-02  2.61517626e-01  1.58141920e-03
  -1.72011980e+00]]",[-0.70716207]
606,PWON.JK,967,241,0.6016597510373444,383,584,[[-0.18275305 -0.04166833  0.05465164  0.01418326 -0.14856516]],[-0.42755877]
607,PYFA.JK,967,241,0.6721991701244814,287,680,"[[-5.61211351e-03  2.69608403e-04 -7.66670973e-04 -4.59321750e-03
  -1.54429407e+00]]",[-0.85983612]
608,PZZA.JK,962,240,0.7541666666666667,347,615,[[-0.08497171 -0.04997508 -0.01982744  0.0022056  -0.65111251]],[-0.56637967]
609,RAFI.JK,125,31,0.7096774193548387,44,81,[[-0.05476368 -0.0135701  -0.43251537 -0.05881439 -0.34267675]],[-0.61359597]
610,RAJA.JK,967,241,0.5394190871369294,332,635,[[-0.05520782  0.01096104  0.03802621  0.00137642 -0.23000217]],[-0.64543556]
611,RALS.JK,968,241,0.6639004149377593,372,596,[[ 0.00010243 -0.00722555  0.00511632  0.00381329  0.08017817]],[-0.47004797]
612,RANC.JK,967,241,0.6721991701244814,304,663,[[ 0.07872985 -0.06572154  0.07016575 -0.01503889 -0.33172583]],[-0.77924611]
613,RBMS.JK,967,241,0.8713692946058091,214,753,[[-0.32753708  0.01830761 -0.0312791  -0.00540398 -0.52362968]],[-1.2691927]
614,RCCC.JK,128,31,0.3870967741935484,49,79,"[[-2.17684639e-02  7.42980365e-05 -4.17992919e-02  6.06605709e-03
  -9.29792899e-02]]",[-0.45641095]
615,RDTX.JK,968,241,0.7219917012448133,169,799,[[-0.13576137 -0.00875192 -0.02786403  0.00417515 -0.75032183]],[-1.55524679]
616,REAL.JK,641,160,1.0,93,548,[[-0.17145322 -0.11353354  0.7884184  -0.00370877 -0.25618735]],[-1.80038868]
617,RELI.JK,967,241,0.7219917012448133,186,781,[[-0.6380044   0.02544392 -0.02248009 -0.003442   -0.52605826]],[-1.43584206]
618,RICY.JK,967,241,0.6473029045643154,313,654,"[[-3.63830591e-01 -1.90740541e-02 -1.36375111e-01  7.77633149e-04
  -2.35687539e+00]]",[-0.73810741]
619,RIGS.JK,967,241,0.6348547717842323,352,615,[[-0.04419336 -0.00648979 -0.05360121 -0.01663012 -1.06742712]],[-0.55686347]
620,RIMO.JK,966,241,1.0,130,836,[[-0.0403748   0.00329562  0.12575028 -0.0205971  -0.80753354]],[-1.87356696]
621,RISE.JK,936,233,0.7081545064377682,315,621,[[ 0.2205202   0.06560606 -0.02737276  0.00284435  0.75944542]],[-0.68299293]
622,RMBA.JK,952,238,1.0,240,712,[[ 0.03716179  0.0230552   0.02383757 -0.00424803 -2.04826616]],[-1.09059471]
623,RMKE.JK,252,63,0.6031746031746031,108,144,[[-0.17270236  0.57935672 -0.07408448 -0.04389285  0.47640302]],[-0.31434301]
624,ROCK.JK,495,123,0.7235772357723578,157,338,[[-0.59521314 -0.10525971 -0.01598772 -0.00263557 -1.6616865 ]],[-0.75978884]
625,RODA.JK,967,241,0.7468879668049793,274,693,[[-0.20867762 -0.03569719 -0.01231302 -0.0144812  -1.81154574]],[-0.93468614]
626,RONY.JK,573,143,1.0,128,445,[[-0.03637407 -0.00961157  0.38286281 -0.02761515 -0.86224752]],[-1.26198328]
627,ROTI.JK,967,241,0.6431535269709544,290,677,[[ 0.0103503   0.1359613   0.00780204 -0.00394904 -0.02425593]],[-0.8469732]
628,RSGK.JK,303,75,0.64,109,194,[[-0.04922489  0.09284409 -0.29541997  0.02400922 -0.72987819]],[-0.56924581]
629,RUIS.JK,968,241,0.6265560165975104,288,680,[[-0.25234767 -0.05034595 -0.06284447  0.03972428 -1.29961093]],[-0.8566758]
630,RUNS.JK,303,75,0.5733333333333334,110,193,[[ 0.04685862 -0.04354645 -0.21678763 -0.00941548 -0.61753139]],[-0.55454818]
631,SAFE.JK,968,241,0.7136929460580913,304,664,"[[-8.33223054e-01  1.63090952e-02 -3.03238232e-02  6.30432450e-04
  -1.69013433e+00]]",[-0.77658133]
632,SAME.JK,967,241,0.6141078838174274,341,626,[[-0.00475607  0.03199785 -0.02155118  0.00296962 -0.4001376 ]],[-0.60929003]
633,SAMF.JK,580,144,0.5,196,384,[[ 0.35095477  0.00883161 -0.02806553 -0.02824029  0.77968888]],[-0.67576919]
634,SAPX.JK,887,221,0.669683257918552,206,681,[[-0.5566722  -0.02144682 -0.09884104  0.00845479 -0.00474388]],[-1.1895194]
635,SATU.JK,868,216,0.7777777777777778,213,655,"[[-1.60103430e-01  2.33332637e-02  1.06800709e-03 -5.71865359e-02
  -1.21752730e+00]]",[-1.13699261]
636,SBAT.JK,574,143,1.0,81,493,[[ 0.51031399  1.08230653  0.42931475 -0.03273934  0.87467479]],[-1.77974131]
637,SBMA.JK,303,75,0.6,107,196,"[[ 3.90567014e-01  2.85737761e-04  2.05327809e-02 -3.50531576e-02
   6.78874208e-01]]",[-0.60645444]
638,SCCO.JK,967,241,0.6887966804979253,238,729,[[-0.18968113  0.00207954 -0.01369321  0.02338555 -1.4180371 ]],[-1.1125438]
639,SCMA.JK,968,241,0.6348547717842323,389,579,[[-0.06117658 -0.02133738  0.09356896  0.00465519 -1.0565112 ]],[-0.39664447]
640,SCNP.JK,497,124,0.7258064516129032,157,340,"[[-1.25331463e-01 -1.49883296e-02 -1.67246530e-01  3.08435225e-04
  -3.72946711e-01]]",[-0.77687872]
641,SDMU.JK,967,241,0.5435684647302904,136,831,"[[ 1.34170092e-17 -1.04458168e-07 -1.42059353e-08  1.77564240e-07
  -9.22918456e-17]]",[-2.37497831e-14]
642,SDPC.JK,967,241,0.6265560165975104,329,638,[[-0.51902995  0.00520801 -0.02655936  0.00344589 -0.70380937]],[-0.66547399]
643,SDRA.JK,967,241,0.6680497925311203,227,740,[[-0.78514641 -0.01055642  0.01266011 -0.00451112 -0.56005947]],[-1.17871139]
644,SEMA.JK,234,58,0.7586206896551724,83,151,[[ 0.04148967 -0.03221218  0.09090353  0.04337944 -0.30497405]],[-0.6241663]
645,SFAN.JK,738,184,0.625,247,491,[[ 0.09226567  0.00076191 -0.10482686 -0.02858002 -0.00100671]],[-0.68438713]
646,SGER.JK,511,127,0.7007874015748031,233,278,"[[1.79948259e-01 6.02760437e-02 7.40512337e-02 1.25231711e-04
  1.35013511e-01]]",[-0.18034177]
647,SGRO.JK,967,241,0.6639004149377593,316,651,"[[-6.86239514e-02 -2.96616980e-02 -1.25499110e-03  1.02355648e-02
  -1.74703437e+00]]",[-0.72829583]
648,SHID.JK,968,241,0.6639004149377593,209,759,[[ 0.4061031   0.00785751  0.03693089 -0.0042798   0.08004983]],[-1.29154071]
649,SHIP.JK,967,241,0.5352697095435685,352,615,[[-0.34735848 -0.0065744  -0.01005847  0.0271433  -0.17523052]],[-0.55531138]
650,SICO.JK,185,46,0.7608695652173914,66,119,[[-0.02112162  0.03532154 -0.02262498  0.02233598 -0.41695814]],[-0.58317013]
651,SIDO.JK,968,241,0.6058091286307054,372,596,[[-0.06364323  0.01784731 -0.01164374 -0.03586078 -0.18040435]],[-0.46791949]
652,SILO.JK,968,241,0.5601659751037344,412,556,[[ 0.10359071 -0.03518831 -0.00234745 -0.00927528  0.06437477]],[-0.30114415]
653,SIMA.JK,966,241,1.0,117,849,[[0.21624676 0.03808871 0.70524135 0.01221591 0.29163023]],[-1.98271749]
654,SIMP.JK,967,241,0.6846473029045643,366,601,[[-0.00314852  0.05334205  0.0050334  -0.00730275 -0.15877349]],[-0.50238559]
655,SINI.JK,657,164,0.5792682926829268,242,415,[[-0.38187041  0.00483257  0.00495861 -0.01631253 -1.79010671]],[-0.54019249]
656,SIPD.JK,968,241,0.7178423236514523,253,715,[[-0.51919796  0.01303331 -0.00096332 -0.00133477 -0.79364327]],[-1.03448831]
657,SKBM.JK,967,241,0.6016597510373444,258,709,[[-1.02535233 -0.00448746 -0.02075763  0.00361716 -1.45855912]],[-1.00929346]
658,SKLT.JK,968,241,0.7593360995850622,168,800,[[-0.5507966   0.08514149 -0.04722162  0.0532546  -1.28553163]],[-1.56931444]
659,SKRN.JK,882,220,0.5727272727272728,353,529,"[[-5.86413762e-02  7.64316480e-04  8.67000279e-02  1.58103150e-03
  -9.53825491e-01]]",[-0.40492714]
660,SKYB.JK,966,241,1.0,104,862,[[-0.22301794 -0.15419619  0.02852651  0.02964493 -0.1299948 ]],[-2.12727994]
661,SLIS.JK,676,169,0.6804733727810651,274,402,[[ 0.80732375 -0.01163205  0.05917187  0.0392714   1.44841035]],[-0.39400857]
662,SMAR.JK,968,241,0.5892116182572614,280,688,[[-0.16312507 -0.02093716  0.08742368  0.00431646 -0.09782101]],[-0.89687801]
663,SMBR.JK,967,241,0.6390041493775933,331,636,[[ 0.14874859 -0.14148174 -0.0729468   0.00105269 -0.40098795]],[-0.64424301]
664,SMCB.JK,968,241,0.6887966804979253,318,650,[[ 0.17960344 -0.00427425 -0.0039325   0.00392157 -0.04743176]],[-0.72031446]
665,SMDM.JK,967,241,0.6431535269709544,334,633,[[-0.66568324  0.00598374  0.02763089 -0.00799402 -2.87450377]],[-0.64513517]
666,SMDR.JK,968,241,0.6390041493775933,383,585,[[-0.01349819  0.00064471  0.01019842 -0.00054631 -0.31151234]],[-0.42125702]
667,SMGR.JK,967,241,0.5892116182572614,424,543,[[-0.00986737 -0.00108918 -0.00152515 -0.00912099 -0.56794739]],[-0.24320849]
668,SMKL.JK,726,181,0.5580110497237569,269,457,[[-0.20406724  0.01019259  0.10377135  0.01124777 -1.65818446]],[-0.52846462]
669,SMKM.JK,203,50,0.5,101,102,[[ 0.22336241  0.30422025  0.3252026  -0.08439416  0.24002446]],[0.00813771]
670,SMMA.JK,968,241,0.9087136929460581,150,818,[[-0.15396513  0.05385462  0.00361671 -0.01758179 -0.7301969 ]],[-1.69481065]
671,SMMT.JK,967,241,0.6390041493775933,362,605,"[[-5.29012917e-02 -8.14579246e-03 -5.44499023e-02 -8.04095064e-04
  -1.46525336e+00]]",[-0.50717854]
672,SMRA.JK,967,241,0.6182572614107884,384,583,[[-0.00972429  0.02455408  0.00250258  0.0127714   0.02795341]],[-0.41956194]
673,SMRU.JK,966,241,1.0,92,874,[[-0.31210605  0.14164314  0.37642987 -0.0555702   0.87226197]],[-2.27683001]
674,SMSM.JK,968,241,0.5643153526970954,424,544,[[-0.13917588 -0.06978061  0.00821345 -0.00562087 -0.21751693]],[-0.2443768]
675,SNLK.JK,389,97,0.5154639175257731,183,206,[[ 0.5577131   0.07128447 -0.1729171  -0.03242791  1.50734011]],[-0.10497854]
676,SOCI.JK,967,241,0.6016597510373444,354,613,[[-0.2860265  -0.03341476  0.03256166 -0.00263233 -1.09416102]],[-0.54591037]
677,SOFA.JK,529,132,0.8712121212121212,153,376,"[[ 5.89395091e-01  1.34692593e-01  3.71440233e-01  1.99992368e-04
  -1.17001012e+00]]",[-0.8929505]
678,SOHO.JK,496,124,0.7983870967741935,165,331,"[[-1.99533751e-01 -6.28482274e-02  1.62031777e-01  3.49698447e-04
  -1.21571016e+00]]",[-0.69167143]
679,SONA.JK,967,241,0.983402489626556,73,894,[[ 0.45963565 -0.00395264 -0.00423804 -0.00140195 -0.08640406]],[-2.49851439]
680,SOSS.JK,867,216,0.5416666666666666,339,528,"[[-4.65516387e-01  1.00833461e-03 -4.07870606e-02 -2.48835114e-03
  -1.59996887e+00]]",[-0.44229655]
681,SOTS.JK,847,211,0.6919431279620853,276,571,"[[-4.77454204e-01  2.82923412e-02 -2.63358365e-02  9.74020334e-04
  -2.07796160e+00]]",[-0.7249785]
682,SOUL.JK,38,9,0.7777777777777778,9,29,[[-0.00316485  0.07354626  0.09359658  0.42218861  0.42847197]],[-1.1714065]
683,SPMA.JK,968,241,0.6182572614107884,370,598,[[-0.35944864 -0.02208245  0.11053777 -0.0058091  -1.45865832]],[-0.47777988]
684,SPTO.JK,967,241,0.7302904564315352,320,647,[[-0.01569048 -0.06049886 -0.0245111  -0.00488924 -0.87784335]],[-0.69409121]
685,SQMI.JK,967,241,0.6970954356846473,296,671,"[[ 4.56129676e-01  4.18596822e-04  6.84504511e-02  2.15954863e-03
  -6.80768544e-02]]",[-0.81726561]
686,SRAJ.JK,968,241,0.6307053941908713,334,634,"[[-8.05746396e-01 -1.21876750e-02 -4.10636404e-03 -1.04575990e-03
  -1.38470287e+00]]",[-0.63860195]
687,SRIL.JK,966,241,1.0,256,710,[[-0.2023287  -0.01030572  0.05274144 -0.00544983 -0.56114173]],[-1.0225971]
688,SRSN.JK,967,241,0.8174273858921162,277,690,"[[-1.39610747e-01  3.50502909e-03  1.09368898e-01  3.93470207e-05
  -2.17976056e+00]]",[-0.92073401]
689,SRTG.JK,968,241,0.6099585062240664,377,591,"[[-7.53361984e-02 -3.87702291e-04 -6.99121010e-03 -3.76941573e-03
  -1.61468946e+00]]",[-0.4482618]
690,SSIA.JK,967,241,0.5726141078838174,351,616,[[-0.03820131  0.00631221  0.02819812 -0.00102675 -0.80591202]],[-0.55991702]
691,SSMS.JK,967,241,0.5186721991701245,368,599,[[-0.03093498  0.0101233   0.11217954 -0.00198118 -1.33932336]],[-0.48252333]
692,SSTM.JK,968,241,0.7759336099585062,260,708,[[-0.85424596 -0.07743245 -0.02674209  0.01415458  0.08368273]],[-1.01353082]
693,STAA.JK,202,50,0.64,85,117,[[-0.01247302  0.31280304 -0.78455986 -0.03006165 -1.00573427]],[-0.33819635]
694,STAR.JK,967,241,0.7302904564315352,295,672,[[-0.05985207 -0.0218889   0.00965646  0.00328704 -2.45847345]],[-0.83009353]
695,SULI.JK,967,241,0.5850622406639004,114,853,[[0. 0. 0. 0. 0.]],[0.]
696,SUNI.JK,37,9,0.6666666666666666,15,22,[[-0.00807012  0.36271122  0.5404431  -0.23645461  0.3995    ]],[-0.55150163]
697,SURE.JK,884,220,0.9409090909090909,168,716,[[-0.31346396 -0.03166145 -0.00135956 -0.00136091 -1.23196364]],[-1.44694871]
698,SWAT.JK,946,236,0.7966101694915254,313,633,[[-0.53274774  0.04584345  0.01540049  0.0108908  -0.7592153 ]],[-0.70563989]
699,SWID.JK,142,35,0.6857142857142857,38,104,[[-0.04767801  0.05436726  0.19414282  0.07738393 -0.90653624]],[-1.0061397]
700,TALF.JK,966,241,0.7012448132780082,251,715,[[-0.89276201  0.0353299  -0.10247864 -0.00437007 -1.42876322]],[-1.04774741]
701,TAMA.JK,608,151,1.0,166,442,[[-0.15670578  0.04895637 -0.04032726  0.01059277 -0.39631326]],[-0.99206081]
702,TAMU.JK,968,241,1.0,255,713,[[-0.10021691  0.10532324  0.0148734   0.01620501  0.41855194]],[-1.03049384]
703,TAPG.JK,382,95,0.6736842105263158,157,225,[[-0.1904973  -0.17361516 -0.01102559  0.00647311 -0.39501017]],[-0.36718664]
704,TARA.JK,966,241,0.0,159,807,"[[ 1.14595165e-17  3.47897801e-08  4.73120237e-09 -5.91345330e-08
  -1.65045642e-13]]",[-3.80163637e-15]
705,TAYS.JK,253,63,0.7619047619047619,92,161,[[-0.06182177  0.01613606  0.20337859 -0.0138366   0.34300149]],[-0.57325863]
706,TBIG.JK,968,241,0.5767634854771784,424,544,[[-0.02550507  0.00469314  0.06871908  0.0127252  -0.71425062]],[-0.24679116]
707,TBLA.JK,967,241,0.7053941908713693,386,581,[[-0.09209757  0.01569848  0.14226746  0.00563804 -0.04122725]],[-0.40842573]
708,TBMS.JK,967,241,0.7136929460580913,252,715,"[[-3.34106675e-01  7.16149805e-04 -2.80043137e-02  6.32114709e-03
  -1.25645865e+00]]",[-1.04466525]
709,TCID.JK,967,241,0.6224066390041494,190,777,[[-0.19564086 -0.01153176  0.05674396 -0.0048945  -0.54242657]],[-1.40716493]
710,TCPI.JK,936,234,0.5341880341880342,414,522,[[ 0.12167036  0.10480776  0.04089521  0.02836612 -0.04164788]],[-0.23719726]
711,TDPM.JK,966,241,1.0,245,721,[[-0.3404385   0.01227531 -0.00378074  0.00502109 -0.08100638]],[-1.07598929]
712,TEBE.JK,652,163,0.588957055214724,185,467,[[-0.13493787  0.011121    0.03719024 -0.00086472 -0.23995053]],[-0.92089563]
713,TECH.JK,548,136,0.7720588235294118,212,336,[[ 0.53245807 -0.02141559  0.00476689 -0.04952703  1.37186051]],[-0.48264091]
714,TELE.JK,790,197,0.9949238578680203,150,640,[[-0.32722654 -0.00565332 -0.03460946  0.03271774 -0.15605553]],[-1.45864561]
715,TFAS.JK,688,171,0.5847953216374269,245,443,[[ 0.57634726  0.11265685 -0.00436272  0.05785381  0.0393246 ]],[-0.59039134]
716,TFCO.JK,966,241,0.9004149377593361,229,737,[[-0.09876231  0.01065819 -0.0486623  -0.00093561 -0.1630178 ]],[-1.16803089]
717,TGKA.JK,968,241,0.7053941908713693,213,755,[[-0.20223718  0.07698794  0.00635553 -0.02389788 -0.75597618]],[-1.28877831]
718,TGRA.JK,967,241,0.8464730290456431,307,660,[[ 0.09174759 -0.00355804 -0.0098858  -0.00069209 -0.32525083]],[-0.76105666]
719,TIFA.JK,967,241,0.7302904564315352,323,644,[[ 0.27953043  0.00155285  0.00342108 -0.0369908  -0.63492258]],[-0.68842737]
720,TINS.JK,967,241,0.6099585062240664,393,574,[[-0.11558324 -0.09535875 -0.04452652  0.00437249 -0.55308788]],[-0.37960878]
721,TIRA.JK,967,241,0.6473029045643154,302,665,[[-0.67589442 -0.00368072  0.02778161 -0.04563441 -1.75060077]],[-0.79367104]
722,TIRT.JK,967,241,0.8298755186721992,252,715,[[-0.54365913  0.01396466 -0.03855195 -0.0045422  -3.08977258]],[-1.06111624]
723,TKIM.JK,967,241,0.6058091286307054,397,570,[[-0.16855569  0.03136874 -0.00990711  0.05346952  0.4677931 ]],[-0.36667023]
724,TLDN.JK,184,45,0.6444444444444445,39,145,[[-0.03626979 -0.15095722 -0.28230907  0.00630511 -0.90383607]],[-1.30727672]
725,TLKM.JK,967,241,0.5477178423236515,416,551,[[-0.18167789  0.01570037 -0.01653407 -0.00136969 -0.60350934]],[-0.28675697]
726,TMAS.JK,968,241,0.5269709543568465,316,652,[[ 0.0820626   0.07128764  0.00502756 -0.00851414 -0.76906423]],[-0.71438502]
727,TMPO.JK,967,241,0.6763485477178424,295,672,"[[-7.17669153e-01  1.16005367e-02  5.79956032e-03 -2.23955633e-04
  -2.19619439e+00]]",[-0.82015637]
728,TNCA.JK,941,235,0.6680851063829787,341,600,"[[-3.85753742e-02 -1.90344872e-04  1.14943169e-01  3.94355559e-04
  -7.53828316e-01]]",[-0.56103786]
729,TOBA.JK,967,241,0.6556016597510373,258,709,"[[ 5.30270489e-02  6.98739800e-03  1.14333708e-01 -7.35248054e-04
  -7.96133905e-01]]",[-1.00756545]
730,TOOL.JK,124,30,0.7,26,98,"[[-2.53682514e-02 -7.56044187e-02  5.18941268e-01  1.39658334e-03
   1.66804620e+00]]",[-1.33582009]
731,TOPS.JK,966,241,1.0,141,825,[[0. 0. 0. 0. 0.]],[0.]
732,TOTL.JK,967,241,0.6265560165975104,310,657,[[-0.08342639  0.00356901 -0.05184818 -0.02030266 -0.30218791]],[-0.75423405]
733,TOTO.JK,967,241,0.6846473029045643,302,665,"[[-1.04681244e-01 -8.29897977e-03 -1.15347201e-04  2.45083375e-02
  -2.51035189e+00]]",[-0.79594342]
734,TOWR.JK,967,241,0.5933609958506224,368,599,[[-0.12540379 -0.01149824 -0.0104173   0.01966601 -1.14032935]],[-0.48321048]
735,TOYS.JK,512,128,0.7265625,164,348,[[ 0.1161826  -0.12205609  0.44325992 -0.04643732 -0.54891845]],[-0.77052972]
736,TPIA.JK,968,241,0.5933609958506224,462,506,[[ 0.6550338  -0.03068356 -0.33146509 -0.01356603  0.54437183]],[-0.10904712]
737,TPMA.JK,967,241,0.5767634854771784,278,689,[[ 0.00926292 -0.08271645  0.0300731  -0.00104021 -0.24627751]],[-0.90353922]
738,TRAM.JK,966,241,1.0,125,841,[[-0.68640878  0.04605805 -0.07394609  0.0898618  -0.48413927]],[-1.92192393]
739,TRGU.JK,141,35,0.7142857142857143,37,104,[[-0.04947201  0.04393369  0.6907062   0.01277399 -0.76847465]],[-1.00875608]
740,TRIM.JK,967,241,0.6224066390041494,305,662,[[-0.30827446 -0.00771276 -0.1015038   0.03228862 -2.973569  ]],[-0.79341401]
741,TRIN.JK,622,155,0.6516129032258065,237,385,[[ 0.09540865  0.06365152  0.09169023 -0.01104516 -0.02761431]],[-0.47693987]
742,TRIS.JK,968,241,0.6224066390041494,300,668,[[-0.6068412  -0.02299688  0.02626477  0.0087044  -0.91762319]],[-0.79570806]
743,TRJA.JK,503,125,0.6,210,293,[[ 0.00250097  0.08083592 -0.11822485  0.0119851   0.34273455]],[-0.34023957]
744,TRON.JK,4,1,1.0,2,2,[[-0.00133418  0.08798361  0.45320118 -0.00567692  0.08787555]],[-0.21853261]
745,TRST.JK,966,241,0.7385892116182573,159,807,"[[-5.70422938e-02  1.28799201e-01  1.35864214e-02  2.03558218e-04
  -1.88884266e+00]]",[-1.64492411]
746,TRUE.JK,352,87,0.9770114942528736,88,264,[[-0.0129895   0.13536848 -0.44828072  0.08243753 -0.29315006]],[-1.11982056]
747,TRUK.JK,961,240,0.65,326,635,[[-0.24336369 -0.01114568 -0.04092994  0.01040494 -0.22270568]],[-0.66382266]
748,TRUS.JK,968,241,0.6141078838174274,274,694,[[-0.91932302 -0.00101236  0.0230827  -0.00264054 -0.60607328]],[-0.92460701]
749,TSPC.JK,968,241,0.6680497925311203,344,624,[[ 0.03847637  0.01043161 -0.0202025  -0.00301387 -0.2603301 ]],[-0.59502083]
750,TUGU.JK,960,239,0.5815899581589958,293,667,[[-0.29430813  0.04433894  0.03184916  0.00700471  0.09949737]],[-0.82548561]
751,UANG.JK,530,132,0.6363636363636364,168,362,[[-0.12638318 -0.02222427  0.00194878 -0.09195259 -0.78647427]],[-0.77124451]
752,UCID.JK,633,158,0.6708860759493671,224,409,[[-0.00434798  0.00166525 -0.08548205 -0.00953272 -0.16652049]],[-0.60190484]
753,UFOE.JK,420,104,0.5673076923076923,173,247,[[ 0.42203487 -0.02802559 -0.025283    0.0082752   1.95256781]],[-0.36721331]
754,ULTJ.JK,967,241,0.6099585062240664,349,618,[[-0.13748111  0.01162927  0.10303914 -0.0043677  -0.73579001]],[-0.56728873]
755,UNIC.JK,967,241,0.6721991701244814,314,653,[[-0.03164349  0.01519026 -0.02618638  0.00134184 -0.86671907]],[-0.72668998]
756,UNIQ.JK,400,100,0.69,102,298,[[-0.18650612 -0.02438566  0.27912447  0.00346272 -2.69791107]],[-1.09025152]
757,UNIT.JK,967,241,1.0,212,755,"[[-4.75199896e-01 -5.47138267e-03  1.01545497e-03  1.41475639e-02
  -1.45125950e+00]]",[-1.27527215]
758,UNSP.JK,967,241,0.5933609958506224,368,599,[[-0.09132802  0.01595526 -0.01668242 -0.01384614 -0.84908027]],[-0.48119063]
759,UNTR.JK,967,241,0.5435684647302904,431,536,[[-0.04314594 -0.03417959  0.00647655 -0.00949305 -0.92268883]],[-0.21069378]
760,UNVR.JK,968,241,0.5394190871369294,396,572,[[-0.02191899  0.01856403 -0.01006478 -0.0005396  -0.52348228]],[-0.36485509]
761,URBN.JK,848,211,0.5971563981042654,187,661,[[ 0.16014767 -0.00045969 -0.03748837  0.00409627 -0.00921956]],[-1.26787821]
762,UVCR.JK,326,81,0.654320987654321,122,204,[[-0.00685979 -0.07522756 -0.40846299  0.08666025  0.81767165]],[-0.55131118]
763,VAST.JK,20,5,0.8,5,15,[[-0.01231402 -0.32569353 -0.27246696 -0.08217546 -0.21272293]],[-1.23082647]
764,VICI.JK,442,110,0.5818181818181818,158,284,[[ 0.12431297  0.03640397 -0.16074307  0.02297591  0.39067957]],[-0.56789933]
765,VICO.JK,967,241,0.6680497925311203,331,636,"[[-4.22317071e-01  1.42252927e-03 -6.65579885e-03 -2.53042805e-03
  -3.10897307e+00]]",[-0.65943328]
766,VINS.JK,967,241,0.6307053941908713,357,610,[[-0.72472932 -0.00433777  0.00933292  0.00258214 -1.75003914]],[-0.52885159]
767,VIVA.JK,967,241,1.0,171,796,[[-0.13000506  0.06969374 -0.03149284 -0.02414924  0.89062088]],[-1.54052319]
768,VOKS.JK,967,241,0.5518672199170125,363,604,[[-0.2721637   0.03651729  0.05170415  0.00232092 -1.00854847]],[-0.50780286]
769,VRNA.JK,968,241,0.6348547717842323,248,720,[[-0.64263763  0.04118353  0.03759079 -0.00168228 -0.11725008]],[-1.07109538]
770,VTNY.JK,51,12,0.6666666666666666,22,29,[[-0.01033971 -0.39863858  0.29971514 -0.04235398 -0.10187243]],[-0.35822752]
771,WAPO.JK,968,241,0.6307053941908713,298,670,"[[-7.94623453e-02 -4.17573380e-04 -8.61752648e-03 -2.51773033e-03
  -2.04632285e+00]]",[-0.81206651]
772,WEGE.JK,967,241,0.6556016597510373,373,594,[[-0.03244536 -0.01473203 -0.00735955 -0.00602413 -1.07951917]],[-0.46213589]
773,WEHA.JK,967,241,0.6390041493775933,297,670,[[0.01422741 0.02202631 0.02713621 0.0014375  0.52627307]],[-0.82332681]
774,WGSH.JK,253,63,0.6507936507936508,95,158,[[-0.00265983  0.05216631  0.10143935 -0.00215534 -0.23921682]],[-0.50836983]
775,WICO.JK,966,241,0.7842323651452282,183,783,[[-0.66427413  0.01893867 -0.00265864  0.02465012 -2.40377035]],[-1.47633365]
776,WIFI.JK,436,109,0.6238532110091743,153,283,[[ 0.01170362 -0.06453397  0.04274526 -0.00334895  0.36240842]],[-0.61795546]
777,WIIM.JK,967,241,0.5684647302904564,329,638,[[ 0.00678928 -0.01278666 -0.00241246 -0.0006233   0.15779827]],[-0.66373652]
778,WIKA.JK,967,241,0.6514522821576764,398,569,[[ 0.00052723  0.02293719  0.02434909 -0.00214459 -0.33906656]],[-0.35252292]
779,WINE.JK,36,9,0.6666666666666666,15,21,[[ 0.00132656 -0.0558771   0.32390273  0.32288416  0.04340543]],[-0.40542318]
780,WINR.JK,177,44,1.0,7,170,[[-0.03673731  0.12959987  0.22609809  0.32020076  0.49577938]],[-3.1758627]
781,WINS.JK,967,241,0.5560165975103735,310,657,[[-0.31878353 -0.00739791  0.28533614  0.01459487 -2.09858996]],[-0.75904679]
782,WIRG.JK,188,47,0.6170212765957447,58,130,[[ 0.03938075  0.0830138   0.12236163  0.00255508 -0.59111421]],[-0.79757454]
783,WMPP.JK,253,63,0.8412698412698413,98,155,[[ 0.13423358  0.00665885  0.07611802  0.01164206 -0.94448031]],[-0.45649852]
784,WMUU.JK,419,104,0.7884615384615384,141,278,[[-0.13341076 -0.10971589  0.02076208  0.08215148 -0.85618228]],[-0.68326266]
785,WOMF.JK,967,241,0.6182572614107884,343,624,[[-0.28201295  0.00142086  0.01910073 -0.01477368 -1.2566726 ]],[-0.59251579]
786,WOOD.JK,967,241,0.6265560165975104,352,615,[[-0.1025624   0.02569335  0.01212794 -0.00375293 -0.26433252]],[-0.56257914]
787,WOWS.JK,657,164,1.0,117,540,[[-0.16523005 -0.00451299 -0.00099317  0.01777219 -0.421924  ]],[-1.52893943]
788,WSBP.JK,967,241,0.991701244813278,328,639,[[-0.08908895 -0.01327439  0.07828758 -0.00058895 -0.45681303]],[-0.66733047]
789,WSKT.JK,966,241,0.6887966804979253,375,591,[[ 0.00256429 -0.00383281  0.00163587 -0.0002909  -0.00152404]],[-0.45426496]
790,WTON.JK,967,241,0.6390041493775933,365,602,[[-0.23063251 -0.01527797 -0.06650233 -0.03448923 -0.08526983]],[-0.50506325]
791,YELO.JK,872,217,0.7050691244239631,219,653,[[-0.00986773 -0.02149462 -0.01156446 -0.0138124  -0.83401281]],[-1.09294139]
792,YPAS.JK,967,241,0.6348547717842323,251,716,[[-0.55255873 -0.00188908  0.05333107 -0.00390264  0.41732503]],[-1.06218307]
793,YULE.JK,967,241,0.7800829875518672,249,718,[[-0.26747763  0.00303344  0.0208098  -0.00687694 -1.13623393]],[-1.06081933]
794,ZATA.JK,71,17,0.7647058823529411,16,55,[[ 0.01512692  0.8781131  -0.05694697  0.12939322  0.76831447]],[-1.17660088]
795,ZINC.JK,967,241,0.8672199170124482,363,604,[[ 0.17916688  0.08139519 -0.01044174 -0.00275715  0.19365946]],[-0.5161197]
796,ZONE.JK,845,211,0.5971563981042654,313,532,[[0.18042222 0.09789793 0.03215467 0.03271543 0.35592685]],[-0.54236156]
797,ZYRX.JK,388,97,0.7422680412371134,139,249,[[ 0.0806164   0.01069699  0.19140863 -0.02206928  0.6250521 ]],[-0.58660074]
