,Ticker,Training Data Size,Test Data Size,Accuracy,train_true,train_false,coef,intercept
0,AALI.JK,968,241,0.6058091286307054,425,543,[-0.00783122  0.0130024   0.10160086 -0.00264888 -0.33249089],-0.24630293381419913
1,ABBA.JK,967,241,0.6639004149377593,249,718,[ 0.58782357  0.0937154  -0.07444632  0.03943856 -0.26862868],-1.0672980272774453
2,ABMM.JK,967,241,0.5601659751037344,260,707,[-0.30339467  0.02457919  0.00985933 -0.00102328 -0.72575081],-0.9952495199431589
3,ACES.JK,967,241,0.6099585062240664,424,543,[-0.32700682  0.01917668  0.0023673   0.03526087  0.88158349],-0.25315988553481833
4,ACST.JK,967,241,0.5809128630705395,337,630,[ 0.59912867  0.0067303  -0.0609765  -0.00864303 -0.20302647],-0.6222500385815264
5,ADCP.JK,209,52,0.7884615384615384,60,149,[-0.0638015  -0.16939528 -0.02200406 -0.09731478 -1.03202873],-0.891313738708452
6,ADES.JK,967,241,0.5601659751037344,384,583,[-0.02330494  0.01134937 -0.05753992  0.00162454 -0.58187431],-0.4202526853386046
7,ADHI.JK,967,241,0.6431535269709544,377,590,[ 0.15773291  0.02010566 -0.06481099  0.00418591  0.88017101],-0.45611318522286354
8,ADMF.JK,967,241,0.5933609958506224,387,580,[ 0.00096365 -0.01936044  0.01437497  0.0085228  -0.10085993],-0.4060950964088868
9,ADMG.JK,968,241,0.7136929460580913,354,614,[ 0.06304645  0.01503072  0.01089805 -0.03082259 -0.41754398],-0.5528587270066129
10,ADMR.JK,238,59,0.7627118644067796,105,133,[-0.02919318  0.01548492  0.05714227 -0.00519886 -0.03474415],-0.2285741737507272
11,ADRO.JK,967,241,0.5103734439834025,412,555,[-0.10808706  0.00844688 -0.04195115 -0.03724264 -0.1681133 ],-0.30751666436229297
12,AGAR.JK,644,161,0.6273291925465838,183,461,[-0.47535526  0.01834708  0.06165283  0.01971848 -2.08367674],-0.9143562369272319
13,AGII.JK,967,241,0.5601659751037344,374,593,[ 0.24177095 -0.00358652 -0.0039594  -0.03751438 -0.58872582],-0.4556057588522198
14,AGRO.JK,967,241,0.6307053941908713,366,601,"[-1.30309999e-07  1.08189086e-04 -1.52735163e-05  2.58223713e-05
  2.41728752e-06]",-0.00024899946588245
15,AGRS.JK,967,241,0.6970954356846473,331,636,[-0.11953723  0.11694725  0.04145335 -0.00656042 -1.13592483],-0.6518211424968486
16,AHAP.JK,968,241,0.6887966804979253,284,684,"[-2.01098187e-01 -1.29858036e-02  3.96746189e-02  4.73300362e-04
 -1.77912083e+00]",-0.8780927696549014
17,AIMS.JK,968,241,0.6514522821576764,167,801,[0. 0. 0. 0. 0.],0.0
18,AKKU.JK,967,241,1.0,5,962,[0. 0. 0. 0. 0.],0.0
19,AKPI.JK,967,241,0.6473029045643154,255,712,"[-3.89398461e-01  1.48700103e-02 -9.06637856e-03  1.10245455e-04
 -4.80799327e-01]",-1.0250651567306148
20,AKRA.JK,968,241,0.5560165975103735,408,560,[-0.03530702 -0.06441979  0.06435946  0.0006246   0.34616257],-0.32377515274766633
21,AKSI.JK,967,241,0.6970954356846473,317,650,[ 0.03333998 -0.00789422  0.00082197  0.01103649  0.28394664],-0.725617897722134
22,ALDO.JK,967,241,0.6390041493775933,275,692,[ 0.54414151 -0.02311962  0.02006416 -0.01289035 -0.81815539],-0.9348239582540527
23,ALKA.JK,967,241,0.6473029045643154,297,670,"[-8.48233084e-01 -7.23152162e-04 -3.05341350e-03 -7.88282650e-03
 -9.33505140e-01]",-0.8099993277544261
24,ALMI.JK,968,241,0.6016597510373444,326,642,[-0.56091374 -0.00759921  0.11471141  0.01419823 -2.02300313],-0.6851576231927673
25,ALTO.JK,967,241,0.8672199170124482,195,772,"[-1.34716926e-01  2.62110469e-04  2.02838094e-02  3.46032603e-04
 -2.01188304e+00]",-1.3839525629569418
26,AMAG.JK,967,241,0.6224066390041494,255,712,[-0.49999212 -0.00293049  0.02685096 -0.00536876 -0.46821671],-1.0289884702905587
27,AMAN.JK,588,147,0.782312925170068,167,421,[ 0.31615193  0.00612244 -0.04799507 -0.0022174   0.25864747],-0.9295438372074046
28,AMAR.JK,625,156,0.5384615384615384,228,397,[-0.26350827 -0.03158944  0.13441386 -0.00642501 -0.29163463],-0.5547352986909253
29,AMFG.JK,968,241,0.5850622406639004,255,713,[ 0.12435091  0.01342599 -0.00297127  0.00331375 -0.23174452],-1.0287263194590754
30,AMIN.JK,967,241,0.6556016597510373,266,701,[-0.65640159 -0.01062207 -0.05062637 -0.00795249 -0.93957861],-0.9734663558008577
31,AMMS.JK,126,31,0.6129032258064516,29,97,[-0.04317114 -0.04466349 -0.56012034  0.13778696  0.96846273],-1.31198313014663
32,AMOR.JK,444,110,0.6454545454545455,171,273,[-0.07684974  0.00291575 -0.01377426  0.05141581  0.06544857],-0.47087852733738467
33,AMRT.JK,967,241,0.4979253112033195,346,621,[-0.05033702  0.00130344  0.03417493  0.00566264 -1.2092139 ],-0.5797278208990315
34,ANDI.JK,912,228,1.0,109,803,"[ 2.15511207e-05  3.05041482e-01  3.67866604e-02  1.82384658e-01
 -1.92133633e-02]",-2.0072571257224796
35,ANJT.JK,967,241,0.6431535269709544,276,691,"[-8.16797855e-02  6.36602456e-05 -1.53863156e-03  2.12583882e-02
  1.02470758e-01]",-0.918288060753734
36,ANTM.JK,967,241,0.6307053941908713,408,559,[-0.00429887  0.00789441 -0.00905534  0.05514082 -0.14788565],-0.3115501793396549
37,APII.JK,967,241,0.6431535269709544,303,664,"[-6.15237198e-01 -1.13808373e-02 -6.02808933e-02 -6.29612188e-04
 -1.90374036e+00]",-0.7839224378584932
38,APLI.JK,967,241,0.6556016597510373,314,653,"[-2.85675844e-01 -1.30111802e-02  4.40591892e-02 -1.80964078e-04
 -2.50377910e+00]",-0.7269387394558706
39,APLN.JK,967,241,0.5892116182572614,340,627,[-0.04378976 -0.01551333  0.01940984 -0.02931899  0.16166262],-0.6180491060072756
40,ARCI.JK,342,85,0.5882352941176471,123,219,[ 0.00378791  0.15426693  0.02965939 -0.00670872  0.53146357],-0.5690433400171865
41,ARII.JK,967,241,0.6846473029045643,213,754,[-0.41258081 -0.01946334  0.13890584 -0.01052349  0.18902747],-1.2818827646694981
42,ARKA.JK,727,181,0.9834254143646409,101,626,[ 0.21408768 -0.00563323 -0.41049319 -0.03569411 -0.91477994],-1.8687242934647887
43,ARKO.JK,141,35,0.5142857142857142,50,91,[-0.0411583   0.22423092  0.09443503  0.30718384 -0.04568157],-0.6445793842717463
44,ARMY.JK,966,241,1.0,107,859,[-0.28200787  0.23467591 -0.22483085 -0.01409733  0.60519137],-2.104230315586399
45,ARNA.JK,967,241,0.6473029045643154,346,621,[-0.11732311  0.01110409  0.06440063 -0.00156125 -0.05663961],-0.5796752841277513
46,ARTA.JK,967,241,0.6473029045643154,273,694,[-0.0316855  -0.00145296 -0.01380691 -0.01898886 -1.24369499],-0.937838235193367
47,ARTO.JK,967,241,0.6348547717842323,382,585,[ 0.01146047 -0.00315885 -0.00666603 -0.003883   -0.33954125],-0.4278968667493869
48,ASBI.JK,968,241,0.5311203319502075,222,746,[-0.32927092 -0.05817978  0.08237177  0.00441259 -0.63727936],-1.2093172275861912
49,ASDM.JK,967,241,0.6597510373443983,203,764,[-0.17432906 -0.05976484 -0.06376811 -0.00285841 -1.8161562 ],-1.3351624025077586
50,ASGR.JK,967,241,0.6514522821576764,343,624,[-0.01651949 -0.00375828  0.12723203  0.01675502 -1.1534453 ],-0.5858433668479704
51,ASHA.JK,164,41,0.5853658536585366,57,107,[ 0.09026959 -0.00795705  0.16996125  0.07755565  0.63761991],-0.6142656420584199
52,ASII.JK,967,241,0.5933609958506224,411,556,[-0.0407917  -0.0140172   0.0174556   0.00613829 -1.0205464 ],-0.29631258111167913
53,ASJT.JK,967,241,0.6556016597510373,329,638,"[-1.41504367e-01 -1.77811495e-03  1.28765196e-01  1.37958353e-03
 -2.02149333e+00]",-0.6597660838195744
54,ASLC.JK,225,56,0.5178571428571429,77,148,[-0.06766797 -0.00977006  0.09239091 -0.0143136   0.24341842],-0.6471972537989825
55,ASMI.JK,967,241,0.6721991701244814,288,679,[ 0.44413089 -0.06836321  0.04494922 -0.04361629  0.91944334],-0.8758861892614068
56,ASPI.JK,604,150,0.64,180,424,[-0.06464364 -0.02087161 -0.49629252  0.00742943 -0.44087352],-0.8657131110603475
57,ASRI.JK,967,241,0.5850622406639004,365,602,[-0.17791333 -0.0545772   0.07517902 -0.00748078 -0.68476072],-0.498274378604246
58,ASRM.JK,968,241,0.7344398340248963,177,791,"[-4.70596610e-01 -2.50345626e-03 -1.48658582e-02  6.98624597e-03
 -2.98140449e+00]",-1.5355206009018476
59,ASSA.JK,967,241,0.5809128630705395,375,592,[ 0.00217497 -0.05733759 -0.01470313 -0.01647297 -1.08201981],-0.4598629061580796
60,ATAP.JK,445,111,0.7657657657657657,138,307,[-0.15603543  0.32247918  0.07869844  0.06958279 -1.31381416],-0.8005264478679469
61,ATIC.JK,968,241,0.6099585062240664,260,708,[-0.43634953  0.0023724  -0.03916914 -0.01224609 -1.08912081],-0.9989948294314099
62,AUTO.JK,967,241,0.5684647302904564,397,570,[-0.00514587  0.00431806 -0.03114777 -0.00564857  0.23863651],-0.36218073620515234
63,AVIA.JK,252,62,0.5806451612903226,98,154,[-0.05801375 -0.01795114  0.12745613  0.00942473 -0.2931215 ],-0.4705813790993283
64,AXIO.JK,135,33,0.7272727272727273,44,91,[-0.0484564  -0.13294779  0.4700618   0.03402632 -0.05236693],-0.710771721392347
65,AYLS.JK,606,151,0.6821192052980133,137,469,[ 0.04872692  0.0677189   0.1685479  -0.00216844  0.44291012],-1.2265728144662806
66,BABP.JK,968,241,0.6680497925311203,130,838,[ 0.64328353  0.09301776  0.04951692  0.01029843 -0.28425281],-1.8638130553154746
67,BACA.JK,967,241,0.7095435684647303,243,724,[-0.25495763  0.03259203 -0.00093755 -0.00084687  0.11240321],-1.0936205868836604
68,BAJA.JK,967,241,0.6763485477178424,312,655,[-0.17284909  0.01720782 -0.00802582 -0.01721817  0.13009533],-0.7525640151105523
69,BALI.JK,967,241,0.6058091286307054,336,631,"[-4.85395562e-01  8.09309993e-02 -2.88622883e-03  2.73401315e-04
 -2.31452238e-01]",-0.6336006137814947
70,BANK.JK,420,104,0.5769230769230769,178,242,[-0.25500206 -0.06910914  0.02959353 -0.03709916  0.01455966],-0.3091674656545956
71,BAPA.JK,967,241,0.6680497925311203,197,770,[-0.35605355  0.0021011   0.01309077  0.00219595 -1.77208154],-1.3641078474512114
72,BATA.JK,967,241,0.6846473029045643,267,700,[-0.1569925   0.00397715 -0.08382993  0.00975276 -2.85550918],-0.9796956791958376
73,BAUT.JK,223,55,1.0,17,206,[-0.07778923  1.3362721  -0.06094843 -0.66178269 -0.31285493],-2.5785056495932803
74,BAYU.JK,967,241,0.7676348547717843,243,724,[-0.51816767 -0.01266174  0.11806767  0.00056922 -0.31543124],-1.0994878496816813
75,BBCA.JK,968,241,0.5228215767634855,436,532,[-0.13567997 -0.01344422  0.0039706   0.00491103 -1.48812163],-0.19710184065074418
76,BBHI.JK,967,241,0.6680497925311203,355,612,[ 0.04717751  0.00363054 -0.06365509  0.00165301 -0.48215399],-0.5409484936199798
77,BBKP.JK,967,241,0.7053941908713693,324,643,[ 0.03182439  0.06317342  0.03726581 -0.02997117 -0.0234828 ],-0.700389153965716
78,BBLD.JK,967,241,0.6099585062240664,179,788,"[-2.21467411e-01  3.78745548e-02  9.74282933e-03 -5.13341336e-04
 -1.54232638e+00]",-1.4892501428434743
79,BBMD.JK,967,241,0.8049792531120332,173,794,[ 0.06368922  0.08870343 -0.09633998  0.00104243  0.09811559],-1.5383157413724824
80,BBNI.JK,967,241,0.5684647302904564,426,541,[ 0.03528387  0.022873    0.2493872  -0.00529776  0.26115693],-0.24150835999483622
81,BBRI.JK,967,241,0.5062240663900415,436,531,[-0.04654817 -0.00751057 -0.00313877  0.00511544 -0.41346666],-0.19442190074183663
82,BBSI.JK,497,124,0.5483870967741935,207,290,[ 0.21238986 -0.2035227   0.02951015 -0.00215579 -0.59908256],-0.3416686879011391
83,BBSS.JK,572,142,0.6619718309859155,151,421,"[-1.45020703e-01  7.70068755e-02  1.18386020e-01  2.57300946e-04
 -1.39750203e+00]",-1.0318245878867218
84,BBTN.JK,967,241,0.5975103734439834,398,569,[ 0.00519012  0.00726034  0.00525733 -0.00690278 -0.06434039],-0.35532343658785936
85,BBYB.JK,967,241,0.6224066390041494,329,638,"[ 3.38191897e-02  7.58270173e-05  8.16700381e-03 -1.15782559e-02
 -7.69714636e-01]",-0.6564339582673606
86,BCIP.JK,967,241,0.6514522821576764,217,750,[-0.24515641  0.13726487 -0.04740909  0.0112319  -0.54524301],-1.2499224143437573
87,BDKR.JK,7,1,0.0,4,3,[0.00166902 0.0478292  0.01052906 0.38753354 0.04444318],0.3315193001955207
88,BDMN.JK,967,241,0.6182572614107884,379,588,[ 0.43506399  0.00265888  0.00553262 -0.00645083  0.33387436],-0.43817069463958064
89,BEBS.JK,399,99,0.9191919191919192,180,219,[0.43588465 0.02921995 0.0072233  0.01700407 0.97383736],-0.20444952437173516
90,BEEF.JK,829,207,0.6811594202898551,261,568,[-0.13970543  0.12695827 -0.00853578 -0.00656676 -0.8463238 ],-0.7804569547267755
91,BEER.JK,38,9,0.6666666666666666,14,24,[-0.0087194  -0.81941335 -1.06878732  0.2641119  -0.02228154],-0.6749953526244348
92,BELI.JK,72,18,0.7222222222222222,20,52,[-0.0018408  -0.26882937 -0.03699949  0.21558425 -0.28176382],-1.0504356458967925
93,BELL.JK,968,241,0.6431535269709544,290,678,[ 0.5849564   0.01133901  0.0560527   0.01323564 -1.45096954],-0.8575043528269674
94,BESS.JK,592,147,0.5918367346938775,249,343,[ 0.32380734 -0.01966513  0.04099345 -0.01725292  1.5234207 ],-0.332526934875056
95,BEST.JK,967,241,0.6182572614107884,335,632,[ 0.00364092  0.08067424  0.04756548 -0.01605545 -0.06545159],-0.6356179967499821
96,BFIN.JK,967,241,0.5477178423236515,349,618,[ 0.02357755 -0.0124451  -0.00744037  0.0840923  -0.69925925],-0.5726759894348035
97,BGTG.JK,967,241,0.6804979253112033,270,697,[ 0.04483138 -0.02984035 -0.07177559 -0.00810724 -0.7028834 ],-0.9451966580008055
98,BHAT.JK,571,142,0.6267605633802817,243,328,[ 0.01560903  0.01110189  0.09921547 -0.00156315 -0.76224475],-0.29445559446680075
99,BHIT.JK,968,241,0.7302904564315352,245,723,[-0.12321442 -0.00791242  0.16160488  0.01623288 -0.98234752],-1.08799185415429
100,BIKA.JK,967,241,0.6597510373443983,309,658,[-0.8838199   0.01627765 -0.01097338  0.00203326 -1.50365075],-0.7474988856645206
101,BIKE.JK,196,49,0.7551020408163265,74,122,[ 0.04307215  0.02384834 -0.01079709 -0.09804108  0.02074882],-0.4911635445239835
102,BIMA.JK,967,241,0.6680497925311203,162,805,[-0.0004303  -0.00164576  0.02000121  0.00065225 -0.00261456],-0.17879748953990762
103,BINA.JK,967,241,0.6639004149377593,387,580,[ 0.00637106 -0.00183308 -0.05588487  0.00974711  0.02974932],-0.410389557497538
104,BINO.JK,259,64,0.734375,95,164,[ 0.01140323  0.04924807 -0.2428637  -0.02051621 -0.49067527],-0.5418008732381198
105,BIPI.JK,968,241,0.5767634854771784,63,905,"[ 2.37285517e-02  3.35195679e-02 -3.58817086e-04  1.90910830e-02
 -7.99137709e-01]",-2.6719424310911934
106,BIPP.JK,967,241,0.8298755186721992,214,753,[-0.34397931 -0.06589574 -0.01432071  0.0051168  -1.95402852],-1.2664198992013005
107,BIRD.JK,967,241,0.5601659751037344,354,613,[ 0.02698832 -0.02088019  0.00480349  0.02040094  0.76430298],-0.551697992026729
108,BISI.JK,967,241,0.6182572614107884,338,629,[ 0.18898807 -0.01816281  0.0229953   0.01214669  0.06014522],-0.6276504944699461
109,BJBR.JK,967,241,0.6348547717842323,413,554,[-0.13859791 -0.01799933 -0.00174353 -0.01212357  0.19539401],-0.29695318736112947
110,BJTM.JK,967,241,0.7427385892116183,350,617,"[-5.49537382e-02 -1.43715209e-02  2.98260966e-03  9.48818577e-04
 -1.08647108e+00]",-0.5619219804099395
111,BKDP.JK,967,241,0.6970954356846473,217,750,[-0.20669807 -0.00522982 -0.01657012 -0.01899002 -2.19488757],-1.2462197567977387
112,BKSL.JK,967,241,0.8672199170124482,243,724,[-0.20698063  0.0161962   0.23988453 -0.00806352 -1.48105712],-1.093820187931976
113,BKSW.JK,967,241,0.6348547717842323,295,672,[-0.34889338  0.04293941  0.02286369  0.00452223 -0.26931671],-0.8292503821416296
114,BLTZ.JK,968,241,0.7136929460580913,145,823,[ 0.00187388  0.01620482  0.11823917  0.01753136 -0.00071264],-1.7450740028975649
115,BLUE.JK,728,182,0.6758241758241759,288,440,[-0.01894334 -0.03621418  0.00345212  0.01215396 -1.07059803],-0.4154613769856768
116,BMAS.JK,967,241,0.5892116182572614,286,681,[ 0.00548678 -0.04800231 -0.01100349  0.0004369   0.16732788],-0.8718385655760174
117,BMBL.JK,36,8,0.875,12,24,[-0.00447113  0.01714939  0.19406661 -0.40017108  0.82857374],-0.7630018350837132
118,BMHS.JK,337,84,0.6785714285714286,109,228,[-0.11888399  0.01538876 -0.01763378  0.01441063 -0.06032884],-0.744845539615426
119,BMRI.JK,968,241,0.5145228215767634,437,531,[-0.12212343  0.15857009 -0.01777677 -0.01005625 -0.17248352],-0.20031604191518432
120,BMSR.JK,967,241,0.6597510373443983,333,634,[-0.78207606 -0.0011482   0.01761644  0.00926494 -0.78472686],-0.6382615957101672
121,BMTR.JK,967,241,0.6099585062240664,357,610,[ 0.00011319 -0.00653155 -0.01243129  0.01393735 -0.00296677],-0.5407827541630104
122,BNBA.JK,967,241,0.6473029045643154,362,605,[ 0.35342379 -0.00854307  0.0051592  -0.03196812 -0.61256142],-0.5146958381574812
123,BNBR.JK,968,241,0.7012448132780082,13,955,[0. 0. 0. 0. 0.],0.0
124,BNGA.JK,967,241,0.6265560165975104,363,604,[-0.19291376  0.02524713 -0.04395951  0.01672362  0.44936115],-0.5163509335336697
125,BNII.JK,967,241,0.7136929460580913,331,636,[-0.06985368 -0.02624119  0.01098918 -0.00132042 -1.18596662],-0.6494557043306092
126,BNLI.JK,967,241,0.6556016597510373,367,600,[ 0.13731051 -0.01863075  0.01391238  0.0064687   0.3387866 ],-0.49854704263752064
127,BOBA.JK,273,68,0.6323529411764706,87,186,[-0.0923393  -0.06619269 -0.18303454  0.03567958 -0.89583002],-0.7479940360015392
128,BOGA.JK,967,241,0.6307053941908713,354,613,[-0.03017269 -0.01730369 -0.04537326 -0.00386103  1.19767336],-0.5621864595913572
129,BOLA.JK,740,184,0.6630434782608695,277,463,[-0.03766664 -0.01809966  0.0648877   0.02145091 -1.24712781],-0.5180702828655139
130,BOLT.JK,967,241,0.6846473029045643,268,699,[-0.56451283  0.00496359  0.00916146 -0.01132683 -0.47832528],-0.9550957200512645
131,BOSS.JK,967,241,0.6721991701244814,326,641,[-0.11597201  0.0022919   0.03578864  0.00483626  0.23605539],-0.6771019004935678
132,BPFI.JK,968,241,0.6846473029045643,99,869,[ 0.1518728  -0.01104472  0.02449977  0.00765847 -0.42439203],-2.1816687854477244
133,BPII.JK,967,241,0.9045643153526971,32,935,[0. 0. 0. 0. 0.],0.0
134,BPTR.JK,936,233,0.6566523605150214,312,624,"[-1.01235128e-01  4.49559982e-02  2.18922832e-02 -1.30948763e-03
 -2.10148874e+00]",-0.6947590204851423
135,BRAM.JK,967,241,0.6929460580912863,170,797,[ 0.16249057 -0.01374505  0.00054171  0.01011895  0.15847284],-1.5506507174213329
136,BRIS.JK,967,241,0.6016597510373444,342,625,[ 0.22347808 -0.01089981  0.11761388  0.02312364 -0.07760196],-0.5976552190636639
137,BRMS.JK,967,241,0.6182572614107884,215,752,"[-1.68242939e-02  4.13432454e-03 -1.70458282e-03  7.21883067e-04
 -9.24848887e-01]",-1.249237206404188
138,BRNA.JK,967,241,0.8547717842323651,190,777,[-0.3299189   0.03277652 -0.00335672  0.00102297 -0.56580242],-1.407754452888562
139,BRPT.JK,968,241,0.5933609958506224,416,552,[ 0.16248587 -0.03493248  0.14636743  0.01355377 -0.5690579 ],-0.27960962591338245
140,BSBK.JK,72,18,1.0,12,60,[-0.09118153  0.39881062  1.0983249  -0.2761562   0.22628238],-1.648668087236436
141,BSDE.JK,967,241,0.5850622406639004,392,575,"[-3.30036872e-02  1.05557036e-02 -2.84660597e-03  2.02744972e-04
 -6.29544088e-01]",-0.38322927228376363
142,BSIM.JK,967,241,0.6639004149377593,308,659,"[-4.39998658e-01 -2.77862267e-02 -4.96723741e-03  2.28840960e-04
 -1.47197957e+00]",-0.7550969947604617
143,BSML.JK,247,61,0.7540983606557377,86,161,[ 0.04133094 -0.02287197  0.00482798  0.00336309  0.41289366],-0.6294108270210922
144,BSSR.JK,967,241,0.5186721991701245,349,618,[-0.0965344   0.0327487   0.00452418  0.03126639 -1.01129704],-0.5595902469646108
145,BTEK.JK,967,241,1.0,135,832,[-0.36208336 -0.00297289  0.02598922  0.17594079 -1.00955641],-1.8223480765955098
146,BTON.JK,967,241,0.6224066390041494,353,614,"[-3.75681175e-01  1.51833317e-02 -7.31220588e-03 -8.47704697e-04
 -3.40988036e+00]",-0.5551649254381911
147,BTPN.JK,967,241,0.6224066390041494,385,582,[-0.03108865 -0.00539168 -0.00532788 -0.00183113 -0.85090502],-0.4090844568533508
148,BTPS.JK,967,241,0.6141078838174274,432,535,[-0.0979731   0.03427416  0.07118542  0.00130933  0.32405005],-0.21678884468579285
149,BUAH.JK,124,30,0.2,55,69,[ 0.10142768  0.12239117  0.17483078 -0.04570027  0.19884833],-0.24065692916079057
150,BUDI.JK,967,241,0.6639004149377593,321,646,[-0.057915   -0.02815217  0.00434252 -0.00307645 -1.32428154],-0.6978289737383722
151,BUKA.JK,320,79,0.6329113924050633,123,197,[ 0.02038593  0.24242625  0.06173173 -0.01071389 -0.21621495],-0.47752003634326595
152,BUKK.JK,967,241,0.6141078838174274,355,612,[-0.51546349  0.02289093  0.22797866 -0.00735373 -1.44431225],-0.5340563094095041
153,BULL.JK,968,241,0.5892116182572614,385,583,[-0.07099776 -0.00057903 -0.00474449 -0.0064095  -0.14127548],-0.41347550649433956
154,BUMI.JK,967,241,0.5518672199170125,257,710,[0.05805484 0.04044974 0.04250514 0.01723382 0.16938842],-1.0214894134686618
155,BVIC.JK,967,241,0.6514522821576764,330,637,[-0.26834592  0.01192897  0.1315334   0.06663776 -0.65571324],-0.651364904663669
156,BWPT.JK,967,241,0.7178423236514523,344,623,[-0.22267878  0.00640079 -0.07319686  0.00057928  0.06771919],-0.5987717482822534
157,BYAN.JK,968,241,0.47717842323651455,279,689,[ 0.20490984 -0.00034769 -0.02309072  0.00849055 -0.11840392],-0.90158257845162
158,CAKK.JK,870,217,0.6175115207373272,228,642,[-0.10807222 -0.04551888  0.13688777 -0.0025013  -1.50490448],-1.0498436184004107
159,CAMP.JK,967,241,0.5933609958506224,355,612,[ 0.00397522 -0.00948749 -0.06175647 -0.00096209 -0.52647089],-0.5391764690229726
160,CANI.JK,968,241,0.6556016597510373,255,713,"[-6.79472244e-01 -1.41455819e-04  1.17144395e-02  2.26716880e-02
  1.95505775e-01]",-1.0323961738642613
161,CARE.JK,588,147,0.5986394557823129,221,367,[-0.04752458 -0.08366129  0.00306041  0.11187611  0.33178451],-0.5160516213000226
162,CARS.JK,967,241,0.7634854771784232,160,807,[-0.17285715  0.00676542  0.63739328  0.01949571 -0.09826717],-1.613892642766223
163,CASA.JK,967,241,0.6721991701244814,274,693,[-0.0911452   0.00267711 -0.01790437  0.03390425 -0.40112225],-0.9239156582046179
164,CASH.JK,562,140,0.65,203,359,[-0.14116721 -0.29973079  0.07850368  0.03864458  0.6075537 ],-0.577084783757565
165,CASS.JK,968,241,0.5601659751037344,253,715,[-0.18845549  0.05162446  0.03060568 -0.00283044 -1.03333019],-1.038004278595931
166,CBMF.JK,573,143,1.0,166,407,[ 0.60270632  0.01243657  0.10865471 -0.03570541  0.12604899],-0.902580232398408
167,CBPE.JK,38,9,0.6666666666666666,15,23,[-0.01707133  0.08491607  0.77877388  0.00994066 -0.24384975],-0.4976171526289575
168,CBRE.JK,37,9,0.8888888888888888,8,29,[-0.01131284  0.0197215  -0.04888211 -0.32528243 -0.17484303],-1.2616823009789127
169,CBUT.JK,72,18,0.4444444444444444,34,38,[ 0.00166202  0.08348032 -0.56050275 -0.43990217  0.07004296],-0.16240286598509804
170,CCSI.JK,740,184,0.7282608695652174,282,458,[-0.05126462  0.08723029 -0.05531842 -0.00756003 -1.36754198],-0.4800861836836942
171,CEKA.JK,967,241,0.6348547717842323,391,576,[-0.13546795  0.00740031 -0.05599459  0.00937415 -1.38054023],-0.378595954258604
172,CENT.JK,967,241,0.7095435684647303,333,634,[ 0.04796627 -0.03140572  0.09697949  0.00351642 -0.97905505],-0.6396796060192081
173,CFIN.JK,967,241,0.6224066390041494,334,633,[-0.17243087 -0.03782198  0.0388543  -0.02807544 -0.77570513],-0.6444632401767774
174,CHEM.JK,141,35,0.6571428571428571,45,96,[-0.11582066  0.04739377 -0.3558871   0.01001976 -0.31586819],-0.751379765730838
175,CHIP.JK,20,5,0.4,9,11,[-0.03907916 -0.08121886 -0.13243974  0.39305008  0.08573486],-0.24547339669218599
176,CINT.JK,967,241,0.7302904564315352,309,658,"[-5.28622374e-01  2.94876612e-03  1.98178753e-03  7.11088764e-03
 -2.47729575e+00]",-0.7582773596701585
177,CITA.JK,968,241,0.6680497925311203,283,685,[-0.14590582 -0.00088528  0.00300003  0.02242627 -0.11611518],-0.8832684243511502
178,CITY.JK,888,221,0.6832579185520362,290,598,[-0.23493363  0.04945734 -0.04113822 -0.00265452 -1.27298141],-0.7319192930900686
179,CLAY.JK,824,206,0.7475728155339806,246,578,[-0.14238263 -0.00793809  0.01873129  0.02190232 -1.11477102],-0.8512550461018076
180,CLEO.JK,967,241,0.5975103734439834,336,631,[-0.05815505  0.03886174  0.00436523  0.00970993 -0.04944802],-0.6308910395680264
181,CLPI.JK,967,241,0.6763485477178424,343,624,[ 0.08826414 -0.00869168 -0.01830564  0.01030386 -1.82814481],-0.5959613861182407
182,CMNP.JK,967,241,0.6639004149377593,383,584,[-0.19848164  0.07681518 -0.0207481   0.00649425 -0.19605824],-0.41663826902003964
183,CMNT.JK,303,75,0.72,114,189,[ 0.01050709 -0.14447238 -0.02167043  0.00193066  0.16905168],-0.5177653607967222
184,CMRY.JK,253,63,0.49206349206349204,117,136,[-0.11739122  0.00716    -0.17066768 -0.00301837 -0.113595  ],-0.13775812101266985
185,CNTX.JK,966,241,0.7468879668049793,238,728,[-0.64684205  0.02577571  0.00433841  0.02700455 -2.5317135 ],-1.1254950827233945
186,COAL.JK,108,26,0.6153846153846154,30,78,[-0.05044376  0.05938524 -0.23320365  0.41764639  0.95616634],-0.9911671511927161
187,COCO.JK,790,197,0.6040609137055838,239,551,[-0.15312882  0.02605883  0.01844037  0.00072229 -0.33076154],-0.827841555895391
188,COWL.JK,966,241,1.0,102,864,[-0.16548354  0.09728629  0.6721066  -0.00954737 -0.3606115 ],-2.1365032902827785
189,CPIN.JK,967,241,0.5518672199170125,431,536,[-0.04416465 -0.00224026 -0.00255589  0.00932593 -0.69787635],-0.2184985325912694
190,CPRI.JK,777,194,1.0,25,752,[-0.12847269  1.35317661  0.75570524 -0.05593475 -0.43146032],-3.3222168519710684
191,CRAB.JK,123,30,0.7333333333333333,41,82,[-0.04183734 -0.9842409  -0.66718483  0.53902157 -0.89452799],-0.6729648555496177
192,CSAP.JK,967,241,0.6141078838174274,310,657,[-0.26771825  0.0045423   0.0436337   0.02401728 -1.57905483],-0.7454397915132984
193,CSIS.JK,967,241,0.7053941908713693,272,695,[-0.03745743 -0.01328175  0.0489545  -0.0091137  -0.94424709],-0.9385072848446664
194,CSMI.JK,573,143,1.0,130,443,[ 0.52699646  0.50948982  0.03156198 -0.03864035 -0.14810065],-1.2495725703634037
195,CSRA.JK,625,156,0.5961538461538461,229,396,[-0.05684975  0.15511129  0.04920358 -0.02849135 -0.09960985],-0.5523890049943071
196,CTRA.JK,967,241,0.6224066390041494,399,568,[ 0.07796367 -0.04786576 -0.00636409 -0.00377264  0.01577623],-0.3575813257282287
197,CTTH.JK,966,241,1.0,211,755,"[-2.57026338e-01  1.60841453e-01 -2.27048659e-03 -1.22820426e-02
 -2.45271071e+00]",-1.2949804245984489
198,CUAN.JK,4,1,0.0,2,2,[-0.00657924 -0.07400386 -0.03361651 -0.09117165  0.00336348],8.293087528310482e-05
199,DADA.JK,604,150,1.0,53,551,[-0.37442091  0.03783494  0.18214944  0.05407383  0.94901987],-2.345806112261061
200,DART.JK,968,241,0.6473029045643154,250,718,[-0.63819709  0.00804262 -0.01136293  0.00880604 -0.98902369],-1.0555378294986486
201,DAYA.JK,968,241,0.5892116182572614,212,756,[-0.7846786  -0.00432399 -0.0527872   0.03524891  0.07230486],-1.279174484570604
202,DCII.JK,434,108,0.9166666666666666,96,338,[ 0.6498485  -0.00069047  0.12163682  0.0081366   0.32324497],-1.2761980408880162
203,DEAL.JK,864,216,1.0,246,618,[ 0.46217274 -0.00321101 -0.18012657 -0.00185886  0.96977848],-0.9348934004702796
204,DEFI.JK,967,241,1.0,233,734,[ 0.16030121 -0.00269521 -0.01077167  0.00172329  0.60109498],-1.1615385699894272
205,DEPO.JK,259,64,0.765625,104,155,[-0.06720482  0.01963965  0.0043082   0.0048809  -0.98057929],-0.37931873385283904
206,DEWI.JK,136,34,0.5,63,73,[-0.16670996 -0.04427471 -0.04832291 -0.0184449  -0.29338811],-0.1370916196887868
207,DFAM.JK,967,241,0.7510373443983402,315,652,[ 0.23807985 -0.10468369 -0.00201634 -0.0064374  -1.46162212],-0.7361461816417263
208,DGIK.JK,967,241,0.6597510373443983,128,839,[0. 0. 0. 0. 0.],0.0
209,DGNS.JK,428,107,0.6822429906542056,162,266,[-0.05799616 -0.1896917  -0.2370348   0.00973399 -0.3902568 ],-0.5073774830715253
210,DIGI.JK,895,223,0.9506726457399103,221,674,[-0.43943654 -0.05072161 -0.03248086 -0.02737325 -1.40787844],-1.128105051310334
211,DILD.JK,967,241,0.6390041493775933,337,630,[-0.05936108  0.02849741  0.02334733  0.0078296  -0.83808938],-0.6254705255430792
212,DIVA.JK,856,213,0.5821596244131455,331,525,[ 0.14534486 -0.12974291  0.12608647  0.0070462   0.8386541 ],-0.4601786094207467
213,DKFT.JK,967,241,0.6431535269709544,341,626,[-0.20801947  0.00396563  0.05098523  0.00167123 -1.24235864],-0.6017916161775457
214,DLTA.JK,967,241,0.6182572614107884,315,652,[-0.01194557  0.04590041  0.00347656  0.01993197 -0.95621404],-0.7303383295230977
215,DMAS.JK,967,241,0.6721991701244814,378,589,"[-1.82493272e-02 -1.05537195e-02 -4.41867444e-02  8.72676980e-04
 -1.08942907e+00]",-0.43855690533662883
216,DMMX.JK,668,167,0.6287425149700598,283,385,[ 0.93133719 -0.24557139  0.00206871 -0.00802621  0.07514185],-0.3225111015863117
217,DMND.JK,618,154,0.7532467532467533,205,413,[-0.23470514 -0.03475661  0.26330074  0.00869527 -2.77796893],-0.7038454287024007
218,DNAR.JK,968,241,0.6514522821576764,295,673,[-0.14449078 -0.02460714  0.03376017  0.0187477  -0.63618424],-0.8315749502420983
219,DNET.JK,967,241,0.6639004149377593,237,730,"[-1.77651251e-01  1.54149744e-04 -9.05519342e-02 -1.08508378e-03
 -1.56431371e+00]",-1.1238614061471395
220,DOID.JK,967,241,0.5643153526970954,366,601,[-0.04221057 -0.00788277  0.04843475 -0.0022522  -1.04156879],-0.4944212687401911
221,DPNS.JK,968,241,0.6058091286307054,259,709,[-0.11218269 -0.01726782 -0.0017648  -0.03518602 -1.43712867],-1.0115211236489912
222,DPUM.JK,966,241,1.0,162,804,[-0.54563585 -0.00107623 -0.00355616  0.00325106  0.10800946],-1.6081899027404805
223,DRMA.JK,245,61,0.5081967213114754,98,147,[-0.06983863 -0.10042238 -0.13002045 -0.02216455 -0.53932309],-0.4220462372961326
224,DSFI.JK,967,241,0.6970954356846473,317,650,[-0.40474913  0.00450614  0.00538343  0.00291951 -2.22644729],-0.7152026731543849
225,DSNG.JK,967,241,0.6058091286307054,346,621,[-0.10730861  0.01246665 -0.01223429 -0.00384483 -0.1961025 ],-0.5864234138999922
226,DSSA.JK,967,241,0.8962655601659751,125,842,[0.03039464 0.02118037 0.00547792 0.00271748 0.00927229],-1.9136658209899653
227,DUCK.JK,881,220,1.0,227,654,[0.02376746 0.10012679 0.09177543 0.00149477 0.51719238],-1.0599123606852292
228,DVLA.JK,967,241,0.6846473029045643,307,660,[-0.24710547  0.01210442  0.00716343 -0.00680561 -3.12943658],-0.7751663034564444
229,DWGL.JK,967,241,0.6058091286307054,341,626,"[-2.74938908e-02  5.85581815e-04 -1.08006319e-02  8.51006476e-04
 -1.30432547e+00]",-0.6051300884935884
230,DYAN.JK,967,241,0.6390041493775933,280,687,[-0.33252989  0.03608539 -0.05401827 -0.00676125 -1.46435193],-0.891148569249062
231,EAST.JK,728,181,0.6353591160220995,241,487,[-0.02596171 -0.01206975  0.03118937 -0.05127876 -0.69593504],-0.6998928504622689
232,ECII.JK,967,241,0.8174273858921162,107,860,[-0.12366368 -0.00156503 -0.03759733  0.00527918  0.03002942],-2.0858682769573997
233,EDGE.JK,416,103,0.8349514563106796,142,274,[-0.04326727 -0.13184507  0.05175182  0.01043939 -1.36435471],-0.6682923572254701
234,EKAD.JK,968,241,0.7095435684647303,375,593,[-0.05045187 -0.00922492 -0.01898841 -0.04119155 -0.98635771],-0.4483358631102346
235,ELIT.JK,38,9,0.2222222222222222,19,19,[-0.02286721 -0.37692045  0.01890898 -0.01215887 -0.34047482],0.014559027746020527
236,ELPI.JK,124,31,0.5806451612903226,42,82,[-0.02485154 -0.26863645 -0.26141007 -0.07926279 -1.15151246],-0.6925166263237503
237,ELSA.JK,967,241,0.5643153526970954,377,590,[-0.11799655  0.00561819  0.00271031 -0.01490021 -1.06488796],-0.44253822333737425
238,EMDE.JK,967,241,0.6929460580912863,165,802,[-0.31394323  0.02835391  0.01662222  0.01645272 -0.07591297],-1.5867512146521843
239,ENAK.JK,218,54,0.5555555555555556,94,124,[ 0.09660084 -0.13959793  0.09824174  0.00429787  1.99022649],-0.30297405650379594
240,ENRG.JK,967,241,0.5809128630705395,292,675,[-0.00840086 -0.00998109 -0.01517912  0.00084317 -0.166113  ],-0.83408496008231
241,ENVY.JK,728,181,1.0,88,640,[-0.13267147  0.55480102  0.30332077  0.22046857  0.71800723],-1.9604424304823158
242,ENZO.JK,493,123,0.8211382113821138,61,432,[-0.02147641  0.1786449   0.17054273 -0.01246216 -0.87717018],-1.9496045244900702
243,EPAC.JK,532,133,1.0,96,436,[-0.14465661  0.02637169 -0.40803266 -0.06307767 -0.72798935],-1.547271202018954
244,EPMT.JK,967,241,0.6224066390041494,275,692,[-0.11763661  0.0098044  -0.04838483 -0.00132401 -0.57444478],-0.9192807459237451
245,ERAA.JK,968,241,0.6058091286307054,399,569,[-0.05867558 -0.0108857  -0.00403964 -0.0122576  -0.90371964],-0.348285922585247
246,ERTX.JK,967,241,0.6307053941908713,309,658,[-0.75279636  0.01798397  0.00291418  0.01937552 -1.90171735],-0.7546073130834792
247,ESIP.JK,654,163,0.7791411042944786,218,436,[-0.33664405  0.01880506  0.01962459  0.00468886 -0.09381979],-0.6923245933877401
248,ESSA.JK,967,241,0.5767634854771784,375,592,[-0.13110009 -0.04205041 -0.00678835  0.00725746 -1.02074795],-0.4542708955617216
249,ESTA.JK,592,147,0.6870748299319728,223,369,[-0.08491581  0.00653376 -0.00234289  0.00109335 -0.64832813],-0.5056118066761084
250,ESTI.JK,967,241,0.8132780082987552,281,686,[-0.05032112 -0.00281309  0.01396693 -0.00501609 -0.57053501],-0.8922482199514612
251,ETWA.JK,967,241,0.6265560165975104,154,813,"[-3.62770713e-01 -4.94934289e-04  5.97671380e-02 -1.12951037e-02
 -1.69415083e+00]",-1.6658216709606244
252,EURO.JK,124,31,0.3225806451612903,68,56,[ 0.13804007  0.51656377  0.08508451  0.04566808 -0.32250914],0.16704053489235393
253,EXCL.JK,967,241,0.5975103734439834,399,568,[-0.2779833  -0.00596634 -0.04681515  0.00242147 -0.42570886],-0.3551888354743006
254,FAPA.JK,436,108,0.6018518518518519,188,248,[-0.02887081 -1.06476298 -0.42730691 -0.01315066 -1.24650573],-0.2724217301670594
255,FAST.JK,968,241,0.7344398340248963,288,680,[-0.27516565 -0.01829281 -0.01756794  0.00377499 -1.16974552],-0.8530167370127713
256,FASW.JK,967,241,0.5809128630705395,186,781,"[ 4.88032672e-11 -6.89886950e-04 -9.38861200e-05  1.17269863e-03
 -1.88505868e-09]",-1.0881546991702957e-06
257,FILM.JK,919,229,0.5283842794759825,368,551,[ 0.59259763 -0.00815722 -0.16339373  0.01166259  0.21570032],-0.40272816774027526
258,FIMP.JK,383,95,0.7157894736842105,118,265,[ 0.01526197  0.12028165  0.01797565  0.05617057 -0.94709504],-0.8167622583368993
259,FIRE.JK,967,241,0.7302904564315352,313,654,[ 0.0639729   0.01680191  0.12883872  0.00241835 -0.36877313],-0.7390314133061336
260,FISH.JK,967,241,0.7759336099585062,135,832,[ 0.37773139  0.00218966  0.01213238 -0.01392945  0.32392186],-1.8350487556815849
261,FITT.JK,743,185,0.654054054054054,239,504,[-0.14781924 -0.0928211  -0.035874    0.00235682 -0.19229391],-0.7544786274665906
262,FLMC.JK,335,83,1.0,81,254,[ 0.08580948  0.03251688  0.08380475 -0.00363041  1.16848867],-1.1450335535144947
263,FMII.JK,967,241,0.7136929460580913,206,761,[-0.3302412   0.05682626 -0.05172254  0.00143617  0.05823666],-1.3184254440341256
264,FOOD.JK,831,207,0.6231884057971014,259,572,[-0.46677113 -0.04553611  0.00414261 -0.0218103   0.06038468],-0.7963775573515653
265,FORU.JK,967,241,0.6639004149377593,232,735,[-0.05340427 -0.01852869  0.00262737 -0.01558217 -1.33742356],-1.1549844069931696
266,FORZ.JK,966,241,1.0,133,833,[ 0.07335009 -0.43180234  0.76271547  0.06246388  0.58033453],-1.8755152533075437
267,FPNI.JK,967,241,0.6390041493775933,344,623,[-0.12261419 -0.00711851  0.0312983  -0.00060043 -0.51827538],-0.5896581958125671
268,FREN.JK,967,241,0.7012448132780082,368,599,"[-3.36345352e-02  6.63795089e-04 -8.32502984e-03  7.68426154e-03
 -8.16241097e-01]",-0.478392042064249
269,FUJI.JK,728,181,0.6519337016574586,279,449,"[-1.56705003e-01 -5.49105011e-02  5.72477158e-02 -2.15618838e-03
 -2.93216724e+00]",-0.47505086318706713
270,FUTR.JK,10,2,0.5,5,5,[ 0.01055778 -0.019851   -0.04065408 -0.0349909  -0.08995226],-0.006081744489872432
271,FWCT.JK,24,6,0.6666666666666666,6,18,"[-5.95236987e-04 -2.05151993e-02  1.55455262e-02 -8.36027737e-01
 -1.16920984e-01]",-1.2865243170685752
272,GAMA.JK,966,241,1.0,39,927,[0. 0. 0. 0. 0.],0.0
273,GDST.JK,967,241,0.6556016597510373,307,660,"[-1.87627172e-01 -1.39847212e-02  2.95524480e-02  1.25266657e-03
 -1.37675172e+00]",-0.768111288350518
274,GDYR.JK,967,241,0.6514522821576764,193,774,[ 0.00173244 -0.02992916  0.13990873 -0.00061784 -0.20755795],-1.3907890316957454
275,GEMA.JK,967,241,0.7302904564315352,224,743,[-0.36246957 -0.06653689  0.00419732  0.00243415 -1.0613423 ],-1.1988847064692334
276,GEMS.JK,968,241,0.6141078838174274,115,853,[0.22405291 0.02148212 0.02348892 0.01467662 1.42820426],-2.003635777443821
277,GGRM.JK,967,241,0.5643153526970954,418,549,[-0.05862047  0.07422803 -0.0344499  -0.00458972 -0.19296021],-0.27170798558232045
278,GGRP.JK,686,171,0.6549707602339181,268,418,[-0.30021526  0.01290479  0.0041825  -0.0094623  -0.82591426],-0.43815326221994283
279,GHON.JK,967,241,0.6721991701244814,289,678,[-0.72803621 -0.00326393 -0.00232726  0.00528002 -1.51778231],-0.8463454428140813
280,GIAA.JK,967,241,0.8796680497925311,253,714,[ 0.07600647  0.00498628 -0.00174488 -0.01289751  0.63483623],-1.0404279971636572
281,GJTL.JK,967,241,0.6141078838174274,366,601,[-0.24800876  0.01625451 -0.0202078   0.0163008  -0.16382905],-0.49424509388195637
282,GLOB.JK,967,241,0.6887966804979253,320,647,[-0.69116563 -0.09825045 -0.00182235  0.04056119 -0.62041151],-0.703097798730887
283,GLVA.JK,632,158,0.5063291139240507,224,408,"[-3.13267471e-01 -7.17123924e-02  1.88733727e-03 -4.04740525e-03
 -2.29119313e+00]",-0.5938451687346278
284,GMFI.JK,967,241,0.7676348547717843,313,654,[-0.0242205  -0.03498874 -0.01212962  0.00414813 -0.80709548],-0.7331383985582545
285,GMTD.JK,966,241,0.995850622406639,73,893,[-0.07992529 -0.04623144 -0.02349148 -0.00110141 -0.75273618],-2.519054764147039
286,GOLD.JK,968,241,0.6431535269709544,296,672,[-0.64184729 -0.00798773 -0.01096017 -0.00346481 -2.61784506],-0.8294441903891044
287,GOLL.JK,967,241,1.0,1,966,"[ 6.30245054e-05 -3.84467499e-02 -3.58598360e-02 -3.79891647e-03
 -1.72755265e-03]",-6.87590961954964
288,GOOD.JK,883,220,0.6590909090909091,343,540,[-0.2454354   0.31548527  0.03667044 -0.00246112 -0.25766341],-0.4560725848092498
289,GOTO.JK,184,46,0.5652173913043478,66,118,[ 0.11502474 -0.38932035  0.15677339 -0.05904873 -0.24081868],-0.598955012629309
290,GPRA.JK,967,241,0.6639004149377593,281,686,"[-1.80969598e-01 -1.04352531e-03 -2.92879233e-02  1.93181840e-03
 -2.09782754e+00]",-0.894508481578821
291,GPSO.JK,304,76,0.6447368421052632,103,201,"[-2.17397887e-01  6.60993218e-02  2.22730105e-01 -7.51955396e-04
 -7.84041809e-01]",-0.6703470129007425
292,GSMF.JK,967,241,0.6970954356846473,274,693,[-0.52122631 -0.00270954  0.05243524  0.00937235  0.06122084],-0.9363599393220909
293,GTBO.JK,967,241,0.7966804979253111,172,795,[-0.56804719  0.02538405 -0.02559418  0.09790371 -2.45547374],-1.5572460772483907
294,GTSI.JK,303,75,0.8533333333333334,79,224,[-0.12462728  0.00507639  0.03973294  0.17413391  0.34254648],-1.0573233048949227
295,GULA.JK,127,31,0.5483870967741935,63,64,[-0.04190737  0.29848154 -0.03478492 -0.01432613 -0.7922058 ],-0.005591119908225508
296,GWSA.JK,967,241,0.6016597510373444,323,644,"[-2.08515597e-01 -1.02562262e-01  2.34564691e-02 -5.72060081e-04
 -1.85939590e+00]",-0.6892858758369651
297,GZCO.JK,967,241,0.6307053941908713,124,843,[0. 0. 0. 0. 0.],0.0
298,HAIS.JK,307,76,0.6447368421052632,110,197,[-0.1711517  -0.00677549 -0.03097888 -0.05298116  0.09367673],-0.5918081271922624
299,HALO.JK,20,5,0.4,12,8,[ 0.03445905  0.16971867  0.1297906  -0.68305569  0.12336322],0.5772441742462399
300,HATM.JK,132,32,0.59375,39,93,[-0.08060427 -0.06194283 -0.37521259 -0.03013212 -0.20746098],-0.9117677707812075
301,HDFA.JK,968,241,0.6224066390041494,254,714,[-1.01745804  0.07861306  0.01289816  0.00683628 -0.58832962],-1.033020320546801
302,HDIT.JK,725,181,0.8011049723756906,246,479,[ 0.11816223  0.08235429 -0.05014108 -0.0123156  -0.35665193],-0.679359928402891
303,HEAL.JK,966,241,0.5601659751037344,377,589,[ 0.04066749  0.02999525  0.06801745 -0.00990388 -0.26114735],-0.4469239890139291
304,HELI.JK,967,241,0.6514522821576764,356,611,[-0.08038137 -0.01191801 -0.00189057 -0.00220666 -1.44605852],-0.5374554259540463
305,HERO.JK,967,241,0.6887966804979253,311,656,[-0.49394255  0.01302957  0.09089002  0.0019454  -1.73948807],-0.7533370700402737
306,HEXA.JK,967,241,0.6182572614107884,391,576,[-0.01955631  0.01385071  0.00722325  0.01612314 -0.74806101],-0.3852915641143718
307,HILL.JK,8,2,0.0,7,1,[0.02259604 0.18520273 0.17677649 0.23411636 0.01299958],1.7905319866801008
308,HITS.JK,967,241,0.6846473029045643,258,709,"[-8.97958247e-01 -2.21640287e-04  5.58049956e-02 -2.09632440e-03
 -8.04010638e-01]",-1.0078167385701302
309,HKMU.JK,883,220,1.0,253,630,"[-3.42827051e-02  2.64434889e-04  3.37948944e-02  2.16100013e-02
 -9.95267153e-01]",-0.9090000911324496
310,HMSP.JK,968,241,0.6307053941908713,371,597,[-0.02558624  0.01244767 -0.02371297  0.00206662  0.3609822 ],-0.48387975641680403
311,HOKI.JK,968,241,0.7012448132780082,354,614,[-0.20394745 -0.0197175  -0.00064956  0.00441902 -0.42520808],-0.5494727282089317
312,HOME.JK,966,241,1.0,114,852,[ 0.09154675  0.127393    0.16935552 -0.04005168  0.88433768],-2.0156250842654604
313,HOMI.JK,495,123,0.6260162601626016,246,249,[ 0.34583526 -0.04467941  0.31682153  0.02816369  1.23725947],-0.022458805096316273
314,HOPE.JK,360,90,0.9888888888888889,103,257,[ 0.03938138 -0.00760647 -0.00110435 -0.00348744  0.43009099],-0.9115657341896943
315,HOTL.JK,966,241,1.0,155,811,[-0.16939033  0.00568684 -0.00177882  0.0214257  -0.55922981],-1.654990133648051
316,HRME.JK,776,194,0.7835051546391752,217,559,[ 0.4041635   0.11560016 -0.00587094 -0.02992732  0.26972767],-0.9543925391589837
317,HRTA.JK,967,241,0.6556016597510373,351,616,[-0.08723433  0.02201276  0.10368627  0.00602277 -0.96256749],-0.5602001532521881
318,HRUM.JK,968,241,0.5560165975103735,370,598,[ 0.15779961  0.01547893  0.00458556  0.04984368 -0.04133892],-0.4795763191854891
319,IBFN.JK,966,241,1.0,245,721,[ 0.1079486   0.00572319  0.04251006 -0.00904821 -0.44400649],-1.0800834675564026
320,IBOS.JK,177,44,0.5227272727272727,63,114,[ 0.04930949  0.18398323 -0.20030354 -0.07506065  0.12925188],-0.5991711094086324
321,ICBP.JK,967,241,0.5435684647302904,420,547,[-0.19630395 -0.00251455  0.05094339 -0.00219085 -1.17801979],-0.2617031491373631
322,ICON.JK,967,241,0.7551867219917012,304,663,"[-5.12801894e-01 -4.47191331e-02 -1.83984286e-02 -1.54640338e-04
 -3.12922178e+00]",-0.7984883309011431
323,IDEA.JK,302,75,0.6266666666666667,103,199,[ 0.00759042  0.00653508  0.05323169 -0.04707958 -0.01219936],-0.6504959184595269
324,IDPR.JK,967,241,0.6141078838174274,269,698,[-0.09977376  0.00329396 -0.11074906  0.00337153 -0.90129032],-0.9568487963118956
325,IFII.JK,640,159,0.5786163522012578,239,401,[-0.11439976  0.00624782  0.03391566  0.02137369 -1.01069977],-0.5140695310017056
326,IFSH.JK,642,160,0.65625,201,441,"[ 2.67217946e-02 -1.04443773e-01  3.93779788e-04 -4.62172969e-02
 -9.29475995e-01]",-0.7903146554463553
327,IGAR.JK,967,241,0.6556016597510373,365,602,[-0.20986106  0.00447639 -0.0553043   0.00272753 -2.23877774],-0.49357197781054485
328,IIKP.JK,966,241,1.0,98,868,[-0.35910205  0.19190589  1.57734431 -0.05226157  0.39459065],-2.167557791195952
329,IKAI.JK,967,241,1.0,125,842,[-0.28942329 -0.00096199  0.05311977 -0.01062887 -0.38799232],-1.914413974182821
330,IKAN.JK,606,151,0.7284768211920529,193,413,[ 0.2374539   0.0299642   0.04123145 -0.025702   -0.18095623],-0.7678924905671115
331,IKBI.JK,967,241,0.6514522821576764,268,699,"[-3.70511623e-01  1.53291814e-04  2.78885688e-03  4.33721739e-03
 -2.26933142e+00]",-0.9574066339463156
332,IMAS.JK,967,241,0.5186721991701245,360,607,[-0.08321765  0.00947461 -0.04070772 -0.00737663  0.17587307],-0.5234259437513527
333,IMJS.JK,967,241,0.5892116182572614,326,641,[-0.22164454 -0.00582223 -0.00771333 -0.02314126 -0.12754028],-0.677216683037917
334,IMPC.JK,967,241,0.6390041493775933,373,594,[ 0.04505123 -0.07312622 -0.03187964 -0.00140789  0.07121243],-0.46103733927247137
335,INAF.JK,967,241,0.7012448132780082,350,617,[0.39696753 0.01396222 0.14772269 0.0103318  0.52528511],-0.5744696566417115
336,INAI.JK,967,241,0.7261410788381742,343,624,[-0.41274821 -0.00939033  0.01806396  0.00377192 -3.22154411],-0.5950050255763123
337,INCF.JK,967,241,0.7800829875518672,249,718,[ 0.67071156  0.00441566 -0.01080124  0.00165296 -0.86979838],-1.0595929387199279
338,INCI.JK,967,241,0.6348547717842323,346,621,[-0.5671346   0.03513944 -0.02679937 -0.00183484 -1.79759558],-0.5735091537324504
339,INCO.JK,967,241,0.5684647302904564,410,557,[-0.02315906 -0.0177214  -0.02895543 -0.01152559  0.62194217],-0.3068510306696312
340,INDF.JK,967,241,0.5767634854771784,416,551,[-0.2746547   0.00976215 -0.00310551  0.00062006  0.05998726],-0.2807887322036909
341,INDO.JK,624,155,0.6193548387096774,242,382,[-0.03231971 -0.00394776  0.00951722  0.00076357 -0.33322779],-0.4569262667143398
342,INDR.JK,967,241,0.6348547717842323,367,600,[-0.1375557  -0.04079243 -0.03144535 -0.01786076 -0.12780886],-0.48704143775102376
343,INDS.JK,967,241,0.5975103734439834,345,622,"[-1.05992734e-01 -4.19873296e-04 -8.28298639e-02 -2.99364264e-05
 -1.63017483e+00]",-0.5866814814188824
344,INDX.JK,968,241,0.6970954356846473,283,685,[-0.02378243 -0.00189551 -0.01457177 -0.00155396 -1.3234589 ],-0.8787681825912048
345,INDY.JK,967,241,0.5311203319502075,406,561,[-0.06342097 -0.02562448 -0.0040107   0.02718107 -0.00857728],-0.3274322818458908
346,INKP.JK,967,241,0.5975103734439834,395,572,[-0.39771455 -0.03331702  0.03466061 -0.01609459 -0.37215294],-0.37054920056706
347,INOV.JK,727,181,0.6629834254143646,277,450,[-0.28272589  0.08814461 -0.00701666  0.01075084 -1.3599723 ],-0.4832739954703409
348,INPC.JK,967,241,0.7344398340248963,251,716,"[-4.92576232e-02  5.15611045e-03  1.27261659e-01 -4.66255689e-04
 -1.48485968e+00]",-1.0450366243459845
349,INPP.JK,967,241,0.6970954356846473,211,756,[-0.81385806  0.00957819 -0.02035149  0.00274908 -1.67250116],-1.2753328590688546
350,INPS.JK,967,241,0.7551867219917012,266,701,[ 0.97614099  0.02336555  0.03861189  0.01208211 -0.4127064 ],-0.9657380735337504
351,INRU.JK,968,241,0.6514522821576764,205,763,[-0.20756378 -0.01478783 -0.01572188  0.00150578 -0.13110836],-1.3130531790616087
352,INTA.JK,967,241,0.966804979253112,260,707,[-0.0166694   0.12958854 -0.05393837 -0.0079037  -0.97755827],-1.003107321362917
353,INTD.JK,967,241,0.6970954356846473,298,669,[-0.5288717  -0.00705332 -0.00130823  0.00751238 -0.67551244],-0.8098975028218254
354,INTP.JK,967,241,0.5560165975103735,428,539,"[-8.35953719e-02  2.05488581e-02  5.75233107e-02 -1.10191879e-04
 -6.57255294e-01]",-0.22495148634407586
355,IPAC.JK,340,85,0.6470588235294118,113,227,[ 0.23758171 -0.02590936 -0.00249832  0.00283157 -0.80031735],-0.6868010889946214
356,IPCC.JK,936,233,0.6266094420600858,348,588,[-0.00844316  0.02247787  0.04728492 -0.00490502 -0.46674713],-0.5203508417194429
357,IPCM.JK,967,241,0.6721991701244814,356,611,[ 0.17451155  0.01524995 -0.0033648  -0.00425767 -0.2471658 ],-0.53866927761293
358,IPOL.JK,967,241,0.6390041493775933,336,631,[-0.20410723 -0.00379926  0.03164955  0.00810222 -2.36608504],-0.6249615138770294
359,IPPE.JK,251,62,0.9354838709677419,86,165,[ 0.31155683 -0.08147828  0.07773902 -0.04491622  0.1766819 ],-0.6691194533892394
360,IPTV.JK,728,182,0.7857142857142857,206,522,[ 0.14734135 -0.04164784  0.0311067   0.00407727 -0.5317884 ],-0.9358353673050327
361,IRRA.JK,672,167,0.6586826347305389,265,407,[-0.05876965 -0.07057376 -0.13188105  0.00598221  0.07053349],-0.43821335193546096
362,IRSX.JK,21,5,0.6,7,14,[-0.02111993 -0.35748477 -0.25625452 -0.20546905 -0.10587217],-0.7653636054277742
363,ISAP.JK,54,13,0.6153846153846154,14,40,[-0.0130702  -0.14660532  0.59514351  0.45306207  0.55280984],-1.0455161189601043
364,ISAT.JK,967,241,0.5477178423236515,392,575,[-0.006601    0.01116528  0.0036742  -0.00255839  0.07886145],-0.3865886074787823
365,ISSP.JK,967,241,0.6390041493775933,356,611,"[-1.42480260e-01  5.94705810e-04  3.21984848e-03 -1.01391451e-03
 -1.35445700e+00]",-0.5319925510109252
366,ITIC.JK,730,182,0.6098901098901099,282,448,[ 0.35941747 -0.00221989  0.01169387  0.01184202 -0.24616724],-0.4638570588858769
367,ITMA.JK,968,241,0.6556016597510373,336,632,"[-5.51909123e-01 -1.61437940e-02  9.45742987e-04 -7.97180299e-03
 -1.02020990e+00]",-0.6329511622537624
368,ITMG.JK,967,241,0.5062240663900415,443,524,[ 0.32670203 -0.03477468  0.00751119 -0.001608    0.35658086],-0.16885678645078128
369,JARR.JK,126,31,0.7419354838709677,34,92,[-0.05381402  0.15759992  0.5372909   0.00515465  0.48952906],-1.0282239011535588
370,JAST.JK,757,189,0.6772486772486772,252,505,[ 0.50978152 -0.05010185  0.1339341  -0.01319848  0.29881946],-0.7047878049744756
371,JAWA.JK,967,241,0.6597510373443983,278,689,[-0.36450171 -0.00806501 -0.02063719  0.00565995 -1.16359538],-0.9037112740482842
372,JAYA.JK,805,201,0.6119402985074627,282,523,[-0.44468082  0.1363331   0.09834392 -0.01079228 -0.78760235],-0.6144966924129357
373,JECC.JK,968,241,0.7634854771784232,98,870,[-0.43975246  0.00508873  0.01079054  0.0042927  -0.01985494],-2.1799645676080828
374,JIHD.JK,968,241,0.6680497925311203,230,738,[-0.32438184  0.01145776  0.01353192 -0.06850844 -1.70511473],-1.1882223737348359
375,JKON.JK,968,241,0.5850622406639004,196,772,[-0.50733429  0.00194515 -0.04319165  0.00654737 -1.21013477],-1.3716191232407742
376,JKSW.JK,967,241,1.0,65,902,[-0.26223516 -0.03542075  0.00656842  0.03246844 -1.90640214],-2.664216603195432
377,JMAS.JK,967,241,0.7261410788381742,257,710,[-0.70972828 -0.00343818  0.06388754  0.0172862  -1.9370285 ],-1.015999148559583
378,JPFA.JK,968,241,0.5933609958506224,406,562,[-0.14975358  0.00663751 -0.00526291  0.00175537 -0.02157692],-0.3229274524952594
379,JRPT.JK,967,241,0.6721991701244814,316,651,[ 0.04565641  0.03655596 -0.01728075  0.03892271 -1.01766538],-0.7178746894804311
380,JSKY.JK,967,241,0.9543568464730291,328,639,[-0.00128255  0.04538174  0.06430883 -0.00090467 -0.31966422],-0.6693343713932628
381,JSMR.JK,967,241,0.6224066390041494,420,547,[-0.0013537   0.00147208 -0.00526917  0.01764949  0.00045787],-0.2610495353006031
382,JSPT.JK,967,241,0.8423236514522822,106,861,"[-2.03523743e-01  5.07700456e-03  5.34596447e-02 -1.65538660e-03
 -1.72073575e+00]",-2.107575301760126
383,JTPE.JK,968,241,0.7344398340248963,296,672,[ 0.46255109  0.0029628  -0.28592227  0.02469796  0.66637142],-0.8453123053182645
384,KAEF.JK,967,241,0.6970954356846473,341,626,[ 0.1042196  -0.05028189 -0.0087433   0.00486489 -0.0392198 ],-0.6073045701677898
385,KARW.JK,967,241,0.7095435684647303,291,676,[-0.20827898 -0.01083095 -0.08747107 -0.00152017 -1.26469319],-0.8364446709214186
386,KAYU.JK,730,182,0.9340659340659341,169,561,[-0.64098879  0.06774727 -0.01230257  0.00637921 -0.29139906],-1.2084420374635902
387,KBAG.JK,575,143,1.0,73,502,[-0.00273765  0.19987393  0.75858432 -0.01878074 -0.21007548],-1.9219852463215363
388,KBLI.JK,968,241,0.6639004149377593,326,642,[-0.25911091  0.01360332 -0.08478063 -0.00159298 -1.13111077],-0.6738599535739569
389,KBLM.JK,967,241,0.6265560165975104,363,604,"[-5.75842539e-01 -8.73353368e-04 -1.34458632e-02 -1.75570807e-02
 -2.91392589e+00]",-0.5055145302870904
390,KBLV.JK,967,241,0.6846473029045643,263,704,[-0.37843703 -0.00839338 -0.03461669 -0.00143613  0.00451269],-0.9937909480962382
391,KDSI.JK,967,241,0.6348547717842323,363,604,[-0.22363818 -0.00246745 -0.00547569 -0.00355933 -1.52231487],-0.5071500324250715
392,KDTN.JK,72,17,0.5882352941176471,25,47,[-0.03486145  0.95799962  0.41552384  0.02088862 -0.26952945],-0.6004974209402203
393,KEEN.JK,696,174,0.6091954022988506,272,424,[-0.17890929  0.00782253  0.19299025  0.03291049 -1.56529934],-0.4449700434405862
394,KEJU.JK,648,162,0.6666666666666666,248,400,[-0.02114028 -0.01528378 -0.10092883 -0.00698197 -1.24456752],-0.4782938744114746
395,KETR.JK,71,17,0.5882352941176471,19,52,[-0.06104836 -0.07451926 -0.51153177  0.21479738 -0.38462314],-0.9526337612930319
396,KICI.JK,968,241,0.6307053941908713,280,688,[-0.53237801 -0.0275436   0.00214358  0.00570749  0.14298444],-0.904566242969367
397,KIJA.JK,968,241,0.8589211618257261,304,664,[-0.05539286 -0.10295341  0.00359998  0.02455265 -0.50796821],-0.7860043140729915
398,KING.JK,16,3,0.3333333333333333,10,6,[-0.03879261 -0.11982518 -0.06693309 -0.37378144  0.02025208],0.5213215686598964
399,KINO.JK,967,241,0.6265560165975104,370,597,[ 0.14776245 -0.02929957 -0.0026817   0.03249746  0.4521361 ],-0.48343237380755527
400,KIOS.JK,967,241,0.6224066390041494,271,696,[ 0.20671312 -0.01789225  0.00537679 -0.05939991 -0.26090521],-0.9393049767010331
401,KJEN.JK,732,183,0.6721311475409836,163,569,[ 0.35169575  0.04443425  0.11560351 -0.0139224  -0.04353764],-1.2489057307341145
402,KKES.JK,124,31,0.6451612903225806,47,77,[-0.05639227  0.4026837   0.41253506  0.05838671 -0.36938731],-0.4952993412837369
403,KKGI.JK,967,241,0.5809128630705395,387,580,[-0.07465118  0.02633385  0.02568836 -0.0019075  -1.15781834],-0.40449766773241397
404,KLBF.JK,968,241,0.5435684647302904,415,553,"[-4.18059398e-02  1.62601829e-02 -3.88290530e-02 -4.17206832e-04
 -1.28184210e+00]",-0.28094171516003014
405,KLIN.JK,124,30,0.4666666666666667,20,104,[-0.08884441  0.60526506  0.25347688 -0.26688521 -0.78472937],-1.6915889577572296
406,KMDS.JK,497,124,0.6451612903225806,204,293,[-0.17849184  0.13899026 -0.04300272 -0.02445459 -1.95075778],-0.3605172518460709
407,KMTR.JK,967,241,0.6804979253112033,341,626,[-0.14343284 -0.03226637 -0.03190826 -0.00514318 -0.68097602],-0.6012903679128833
408,KOBX.JK,967,241,0.6141078838174274,375,592,[-0.34897078  0.03038296  0.00523161 -0.00646457 -1.65301868],-0.44878206740277965
409,KOIN.JK,967,241,0.7053941908713693,199,768,[-0.42268903 -0.03830236  0.1036471   0.0343751  -0.50054344],-1.347831289481851
410,KONI.JK,967,241,0.6804979253112033,231,736,[ 0.90129379  0.02188092  0.01994623 -0.00309158  0.10678275],-1.1687808653600342
411,KOPI.JK,967,241,0.6970954356846473,260,707,[-0.29898202  0.0049364  -0.01404147 -0.00569915 -1.00801024],-0.9983593333400912
412,KOTA.JK,728,181,1.0,204,524,[ 0.61503961  0.14538074 -0.0244922  -0.02779086  0.68995407],-0.9546989931056992
413,KPAL.JK,951,237,1.0,191,760,[ 0.01140337  0.1679231   0.14615299 -0.02845094 -0.5030118 ],-1.371172447684869
414,KPAS.JK,884,220,1.0,163,721,[-0.18626153  0.03794829  0.08212894  0.0109073  -0.37859193],-1.4958669350294622
415,KPIG.JK,967,241,0.7219917012448133,273,694,[-0.27671276  0.03783522 -0.12353793  0.00299686 -0.710674  ],-0.9315834530069094
416,KRAH.JK,966,241,1.0,140,826,[ 0.12535233  0.12390153 -0.0884725   0.22965289  0.38589358],-1.7981127357002884
417,KRAS.JK,967,241,0.6597510373443983,362,605,[ 0.04454786  0.01960165 -0.00631081 -0.0112075  -0.10557972],-0.5161644438085783
418,KREN.JK,967,241,0.970954356846473,309,658,[ 0.03684515 -0.06349161  0.00706083  0.00037044  0.31129256],-0.7655189402738537
419,KRYA.JK,132,32,0.6875,42,90,[ 0.205214   -1.42650383  0.54960882 -0.1646022   0.74586996],-0.863598857697309
420,KUAS.JK,277,69,0.782608695652174,90,187,[ 0.03027818  0.10775848  0.00994855 -0.07097603 -1.16709766],-0.7403996708857147
421,LABA.JK,352,87,0.7011494252873564,115,237,[ 0.44418952  0.07717131  0.02841175 -0.06996388 -0.40070876],-0.720223804245627
422,LAJU.JK,27,6,0.8333333333333334,11,16,[-0.01555705  0.74214387  0.43509473 -0.15923533  0.20436667],-0.34429924225004815
423,LAND.JK,909,227,0.8678414096916299,318,591,[-0.44827032  0.20120574 -0.0335364  -0.03553843  0.27282118],-0.6190850834848941
424,LCKM.JK,967,241,0.6804979253112033,245,722,[-0.53879137  0.00307905  0.01823165  0.00423521 -2.37819497],-1.0916560185848887
425,LEAD.JK,967,241,0.5975103734439834,116,851,"[ 9.54814422e-15 -1.33678072e-09 -1.99872458e-10  2.25949218e-09
  2.74485799e-14]",-1.425572918910382e-10
426,LFLO.JK,384,96,0.6875,136,248,[0.01167414 0.05064581 0.14823348 0.04104062 0.31962462],-0.5851408460017907
427,LIFE.JK,728,181,0.8839779005524862,111,617,[ 0.04913058  0.07436377 -0.00097067 -0.05015205 -0.24707809],-1.706099154670533
428,LINK.JK,967,241,0.6224066390041494,388,579,[-0.16790312 -0.01412166 -0.0030102   0.00640668 -0.2543609 ],-0.3954433013409748
429,LION.JK,968,241,0.6307053941908713,258,710,[-0.49691123 -0.00762973 -0.0016619  -0.02835542 -1.2597271 ],-1.013466045288583
430,LMAS.JK,966,241,1.0,178,788,[-0.25365558  0.01588132  0.02110614 -0.01719729 -1.24672256],-1.4919965432629205
431,LMPI.JK,968,241,0.6763485477178424,319,649,"[-6.11787229e-01  2.38745203e-03 -3.04705525e-02  2.84147946e-04
 -2.58964626e+00]",-0.7124695351015321
432,LMSH.JK,968,241,0.6763485477178424,221,747,[ 0.15475849 -0.03633874  0.0181503   0.00725248 -0.05480969],-1.2212911943745826
433,LPCK.JK,968,241,0.6224066390041494,393,575,[ 0.28617042 -0.0160033  -0.01143095  0.0057157   0.1269716 ],-0.37734075067682515
434,LPGI.JK,968,241,0.6265560165975104,196,772,[ 0.05471998  0.02387603  0.01446389 -0.02537414 -0.61553485],-1.3695022361496005
435,LPIN.JK,967,241,0.6473029045643154,306,661,[ 0.14128759 -0.04511009 -0.02041812 -0.01077555 -1.13193462],-0.766453150939205
436,LPKR.JK,968,241,0.6721991701244814,340,628,[-0.03945215 -0.00800802  0.016976    0.00198836 -0.18175887],-0.6157504456034266
437,LPLI.JK,968,241,0.6307053941908713,299,669,[-0.43188982 -0.01415292  0.0880881  -0.01656292 -1.45722415],-0.8074993908697222
438,LPPF.JK,967,241,0.5643153526970954,409,558,"[ 2.38916316e-01  4.29340691e-02 -2.98753318e-03  2.80536618e-04
  6.26611579e-01]",-0.3144001879084138
439,LPPS.JK,968,241,0.7053941908713693,308,660,"[-3.64469723e-01 -8.48071514e-03 -5.59184857e-02  1.08190258e-03
 -2.07897811e+00]",-0.752934817285065
440,LRNA.JK,967,241,0.7012448132780082,307,660,"[-4.88838809e-01 -2.75958086e-06 -1.56699006e-02 -2.07159068e-02
 -2.45385740e+00]",-0.7685450554369216
441,LSIP.JK,967,241,0.6307053941908713,413,554,[-0.00920973  0.00731324 -0.02435617  0.00525618 -0.04051522],-0.2928577864709245
442,LTLS.JK,967,241,0.6307053941908713,354,613,[-0.19107772 -0.07706397 -0.00111663  0.00674027 -0.89134368],-0.5587474201266891
443,LUCK.JK,854,213,0.7183098591549296,301,553,[ 0.27915056 -0.01027014 -0.01807009 -0.01708173 -0.9695772 ],-0.600758575883618
444,LUCY.JK,368,92,0.5978260869565217,147,221,[ 0.28086194 -0.0529544  -0.00118081 -0.03915156  0.71671027],-0.4293034025525274
445,MABA.JK,966,241,1.0,53,913,[-0.48073623  0.25222806  1.01851538  0.07340532  0.85359482],-2.820208559665443
446,MAIN.JK,967,241,0.6721991701244814,390,577,[-0.13158935 -0.01332045 -0.03985689 -0.00409726 -0.72398678],-0.3904604502782912
447,MAMI.JK,967,241,1.0,164,803,[ 1.01302693  0.31077175 -0.14458531  0.0117116   1.00564599],-1.6043645041633634
448,MAPA.JK,937,234,0.5427350427350427,318,619,[-0.00015557  0.00241904  0.00082269  0.00141696 -0.00489072],-0.6687661393540957
449,MAPB.JK,967,241,0.6141078838174274,263,704,"[-1.27084142e-01  1.17882174e-04 -7.52037870e-04 -1.75819271e-03
 -1.95251745e+00]",-0.9857074863453479
450,MAPI.JK,967,241,0.5228215767634855,382,585,[-0.39368924  0.00506085 -0.02510745 -0.00365114 -0.07020485],-0.4290545472024524
451,MARI.JK,967,241,0.6265560165975104,316,651,[ 0.21643961  0.02538125 -0.00450501 -0.00151719  0.04450232],-0.7221963809823697
452,MARK.JK,967,241,0.6182572614107884,392,575,[ 0.08783961  0.00518266 -0.03931576  0.0088973  -0.18060835],-0.3823961376217948
453,MASA.JK,967,241,0.6348547717842323,305,662,[ 0.24081041 -0.00757831  0.03407343  0.0192086   0.09714982],-0.7789396477814108
454,MASB.JK,340,85,0.7411764705882353,92,248,[-0.04105391 -0.03804335 -0.07644203  0.0652401  -2.28185883],-1.0033054396750911
455,MAYA.JK,968,241,0.6721991701244814,175,793,[0.47138609 0.0479829  0.06746709 0.08497568 0.04327814],-1.5288284453632082
456,MBAP.JK,967,241,0.5643153526970954,418,549,[ 0.00017053  0.00250744 -0.00128485 -0.00314035 -0.0012437 ],-0.2700532788092776
457,MBSS.JK,967,241,0.6390041493775933,362,605,[-0.21283789 -0.00505588 -0.00669012 -0.04055353 -0.25368996],-0.5164734656101574
458,MBTO.JK,967,241,0.6224066390041494,348,619,"[-9.78267095e-01  4.48200779e-02  4.50758597e-02  1.97665768e-03
 -2.59359123e+00]",-0.5753946565198815
459,MCAS.JK,967,241,0.6141078838174274,414,553,[ 0.63270895 -0.01645719  0.00472197 -0.02495051  1.51317586],-0.3009381741750753
460,MCOL.JK,304,75,0.6133333333333333,141,163,"[ 4.01811441e-02 -2.67691565e-04  7.58872854e-02  6.16688359e-03
 -3.90255274e-01]",-0.1335864926520062
461,MCOR.JK,967,241,0.7219917012448133,307,660,[-0.25636461  0.02075595  0.04223098  0.00548594  0.20248804],-0.7676239058061106
462,MDIA.JK,966,241,0.9336099585062241,202,764,[-0.57990208 -0.00338641 -0.01124013 -0.01624075 -1.40094618],-1.3325018861917055
463,MDKA.JK,968,241,0.5892116182572614,431,537,[-0.26809351  0.02215724 -0.00050021 -0.00637545 -0.36057278],-0.22299302236946789
464,MDKI.JK,967,241,0.6556016597510373,346,621,[-0.35292339  0.03547952  0.04417835 -0.00354139 -2.41466264],-0.5858363661288875
465,MDLN.JK,967,241,0.6514522821576764,201,766,[ 0.10824664 -0.03772553  0.08036865  0.0081895  -0.91561557],-1.3445912892986314
466,MEDC.JK,968,241,0.5228215767634855,375,593,[ 0.0233681   0.08931099  0.00501616  0.03644719 -0.82278236],-0.4550127026110174
467,MEDS.JK,123,30,0.6333333333333333,46,77,[-0.01928517  0.25111237 -0.40595375  0.18277845  0.60704713],-0.46633178177528395
468,MEGA.JK,968,241,0.6182572614107884,227,741,"[-2.89620098e-01 -3.17315419e-02  1.24781292e-04  2.47806816e-03
  1.37289040e-02]",-1.1847472214324166
469,MERK.JK,967,241,0.5435684647302904,338,629,[ 0.05930602  0.0315923  -0.03559899  0.01519534 -0.38852874],-0.6237943855725994
470,META.JK,967,241,0.6597510373443983,322,645,"[ 1.08050320e-01  1.18965724e-01  1.65465613e-02  4.24052144e-05
 -8.30513948e-01]",-0.6912800491209455
471,MFIN.JK,967,241,0.6390041493775933,294,673,[-0.11545781  0.04261505 -0.01922748 -0.02059903 -2.30553124],-0.831014380810007
472,MFMI.JK,967,241,0.6431535269709544,322,645,[-0.08231262  0.01940839  0.03439152  0.00798494 -1.54128432],-0.6935573698383128
473,MGLV.JK,353,88,0.75,142,211,[-0.01434509  0.03064835 -0.03038253  0.00192333  0.74263944],-0.4018637333685221
474,MGNA.JK,968,241,1.0,9,959,[-0.00610014  0.02143787 -0.73635014 -0.1663559  -0.15892931],-4.716674716283457
475,MGRO.JK,933,233,0.6051502145922747,330,603,[ 0.19919528 -0.02314202 -0.01006671  0.00940619  1.11401896],-0.6136347324408966
476,MICE.JK,967,241,0.5643153526970954,334,633,[-0.29043468  0.0510916  -0.01631621  0.01787536 -1.92928161],-0.6366601900367855
477,MIDI.JK,968,241,0.6016597510373444,183,785,"[-2.80040898e-01  4.98193332e-03 -8.72724097e-02  5.86822306e-04
 -7.76136880e-01]",-1.4559295196616082
478,MIKA.JK,967,241,0.5767634854771784,438,529,[-0.04264559 -0.01258253 -0.07524283  0.01285782 -0.69292676],-0.1865686409453505
479,MINA.JK,967,241,0.8630705394190872,199,768,[ 0.06427154  0.00446961  0.00594839  0.00312774 -0.00937062],-1.354868556548579
480,MKNT.JK,966,241,1.0,107,859,[-0.52128651  0.39091476 -0.04371165  0.03315453 -1.82755652],-2.094376809040827
481,MKPI.JK,967,241,0.6970954356846473,81,886,"[-5.32183037e-05 -4.08839522e-01 -9.26042112e-02  2.57260373e-01
 -1.93449236e-06]",-0.8772201669775908
482,MKTR.JK,72,18,0.5555555555555556,29,43,[ 0.03886227  0.04075622  0.23274483 -0.00449922  0.16197336],-0.4149403023446279
483,MLBI.JK,967,241,0.6265560165975104,279,688,[ 0.11918572  0.02160201 -0.00741223  0.04109955 -0.31616252],-0.9000267461457473
484,MLIA.JK,968,241,0.6348547717842323,391,577,[ 0.01884417  0.00347387 -0.09016253  0.00447748  0.53652726],-0.3965099757161233
485,MLPL.JK,967,241,0.6431535269709544,291,676,[ 0.04851278  0.00850919 -0.02068302 -0.00938031 -0.67282381],-0.8386288446329193
486,MLPT.JK,968,241,0.6099585062240664,311,657,[ 0.24140867  0.00073204  0.00086521 -0.00561406 -0.04751043],-0.7495110196705259
487,MMIX.JK,56,14,0.42857142857142855,22,34,[ 0.09535173  0.06344319  0.2253519  -0.0480043   0.11663811],-0.4433945034964999
488,MMLP.JK,967,241,0.6141078838174274,342,625,[-0.32582778 -0.01608763  0.03215433 -0.00387747 -1.3123404 ],-0.5971740574952003
489,MNCN.JK,967,241,0.6473029045643154,359,608,[ 0.04211878 -0.00362809  0.02440141  0.00604464 -0.55460504],-0.5203129430424714
490,MOLI.JK,905,226,0.6194690265486725,260,645,[-0.52716481 -0.0522565  -0.03227046  0.002354   -0.89349921],-0.903597250598416
491,MORA.JK,124,31,0.6129032258064516,37,87,[-0.04028919 -0.05677712  0.41003443 -0.00560821  0.42581853],-0.7924846826909137
492,MPMX.JK,967,241,0.6348547717842323,363,604,[-0.09941705 -0.00541104  0.07179968  0.00028889 -0.13396714],-0.5094270049087606
493,MPOW.JK,967,241,0.6929460580912863,334,633,[-0.32994704  0.10560973 -0.01026496  0.0039818  -1.1648716 ],-0.63775939140443
494,MPPA.JK,968,241,0.6390041493775933,342,626,[ 0.14638426  0.0399486  -0.0026544  -0.00316583  0.46740772],-0.6091237462217105
495,MPRO.JK,882,220,0.7272727272727273,233,649,[-0.27537363 -0.00389976  0.06799069  0.04750179  0.04977136],-1.0249391436230026
496,MRAT.JK,967,241,0.6058091286307054,332,635,[-0.44884764 -0.01139278 -0.01565396  0.00994364 -1.74436341],-0.6477602874912993
497,MREI.JK,967,241,0.6265560165975104,206,761,[-0.76927792 -0.02771946  0.01645425  0.00200439 -0.58736369],-1.2998186468761537
498,MSIN.JK,952,238,0.6932773109243697,343,609,[ 0.83961895  0.03749788 -0.08961099  0.00366774 -0.04849185],-0.5808330689323788
499,MSKY.JK,967,241,0.6639004149377593,274,693,"[-2.78953761e-01 -9.76718137e-03  7.41865449e-02  2.24788875e-04
 -1.34232248e+00]",-0.9263643969457446
500,MTDL.JK,968,241,0.6556016597510373,410,558,[-0.34962201  0.02524385  0.00154684  0.00751068 -0.09812954],-0.3089600537111769
501,MTEL.JK,261,65,0.676923076923077,92,169,[-0.01205475 -0.00869637  0.16866744  0.13490499  0.09802255],-0.6033856922453901
502,MTLA.JK,967,241,0.6390041493775933,291,676,[-0.33572953  0.02458514  0.00931032 -0.01471628 -1.86685435],-0.8432519083437316
503,MTMH.JK,180,44,0.5681818181818182,53,127,[-0.00633223 -0.64579156 -0.13196988  0.01388211  0.38302509],-0.9110563152034692
504,MTPS.JK,777,194,0.8402061855670103,237,540,[ 0.47739692 -0.02155943  0.2009828   0.01459053  0.05488483],-0.8362425669078237
505,MTRA.JK,966,241,1.0,111,855,[-0.1359446  -0.09621969 -0.0059471  -0.01143857  0.03553432],-2.0606074491222115
506,MTSM.JK,967,241,0.6348547717842323,259,708,[-0.76595722 -0.02069102  0.00114849  0.01852554 -0.72141994],-1.002308717521276
507,MTWI.JK,967,241,0.6680497925311203,324,643,[-0.13460591 -0.02104292  0.01613171 -0.00623052 -1.30509246],-0.6913897080893128
508,MYOH.JK,967,241,0.7302904564315352,353,614,[-0.13797297 -0.0103011  -0.02316581  0.02421936 -0.90810959],-0.5536051440572136
509,MYOR.JK,968,241,0.5518672199170125,343,625,[-0.01736689  0.00436051 -0.02477427 -0.00060729  0.5073961 ],-0.6026540980095819
510,MYRX.JK,967,241,1.0,104,863,[-0.10643708 -0.00537836  0.63329391  0.00307458 -1.75050784],-2.1206224059354573
511,MYTX.JK,967,241,0.6804979253112033,277,690,"[-6.86391371e-01  3.21703774e-02 -7.23463684e-02 -1.42479210e-03
 -2.91497743e+00]",-0.925241416909152
512,NANO.JK,202,50,0.74,46,156,[ 0.03650699 -0.04836302  0.43326544  0.17953033  0.07783969],-1.2080046596280913
513,NASA.JK,967,241,1.0,169,798,[-0.1533567  -0.06930718  0.00519928  0.00753819  0.27783179],-1.5626301234263669
514,NASI.JK,249,62,0.7580645161290323,92,157,[-0.07122187 -0.08814754 -0.24502814  0.01741223  0.57392534],-0.5396136806416814
515,NATO.JK,824,206,0.6262135922330098,306,518,"[ 7.72124955e-02  1.18609563e-03  1.08091507e-02 -5.83104060e-03
  1.47413968e+00]",-0.5429016452009098
516,NAYZ.JK,22,5,0.6,12,10,[-0.04192233  0.44635889  0.00638739  0.22072023  0.08543207],0.14411167914749562
517,NELY.JK,967,241,0.6597510373443983,334,633,[-0.37564288  0.01583406  0.10973707 -0.00198921 -1.51079768],-0.6348215544618758
518,NETV.JK,224,56,0.6964285714285714,72,152,[-0.09710176  0.54052055  0.00775253 -0.00657869 -1.07079066],-0.7314163953356279
519,NFCX.JK,933,233,0.6566523605150214,348,585,"[ 9.62493050e-01  8.74312089e-03  2.99640133e-02 -5.96223816e-04
  8.82402277e-01]",-0.5274767545869088
520,NICK.JK,967,241,0.5435684647302904,312,655,[-0.86264596  0.00194115 -0.00233641 -0.00272898 -1.72628343],-0.7353243663390722
521,NICL.JK,335,83,0.5903614457831325,111,224,[-0.04686028  0.11417477  0.00509119 -0.04291767 -1.25941627],-0.704835284402542
522,NIKL.JK,967,241,0.6721991701244814,355,612,[ 0.32928074 -0.23078232  0.00482068 -0.00895362  0.10543701],-0.546723528841126
523,NINE.JK,57,14,0.7857142857142857,10,47,[-0.00430781  0.45025122 -0.02798565 -0.0654614   0.85608576],-1.6001517049834355
524,NIRO.JK,967,241,0.7136929460580913,237,730,"[-3.54850489e-01 -3.42226368e-04 -1.61308108e-02  6.57016292e-04
 -2.57127277e+00]",-1.1325892506918327
525,NISP.JK,967,241,0.6141078838174274,309,658,"[-5.44906789e-02 -2.85916495e-02 -4.00374608e-02 -3.59507037e-04
 -1.68193758e+00]",-0.7630132230881324
526,NOBU.JK,968,241,0.6514522821576764,239,729,[-0.50694951  0.00295729  0.0460387   0.00133336 -0.14421377],-1.1145291018793084
527,NPGF.JK,380,95,0.8842105263157894,109,271,[ 0.00345364 -0.00956383 -0.12808323  0.03700271  0.08160968],-0.9342686649225016
528,NRCA.JK,967,241,0.5933609958506224,366,601,"[-4.42985057e-02  2.15461615e-02  5.49041782e-03 -8.05107327e-04
 -1.17748764e+00]",-0.48867203757975053
529,NTBK.JK,217,54,0.9629629629629629,10,207,[-0.05959933 -0.2283705   0.07292025  0.03316852 -0.1653245 ],-3.1009488573705934
530,NUSA.JK,932,233,1.0,99,833,"[4.82426116e-01 1.50646146e+00 1.56778442e-01 1.11068690e-03
 4.29147067e-01]",-2.1492661997531055
531,NZIA.JK,683,170,0.6352941176470588,239,444,[ 0.14050676  0.01294336  0.03774587 -0.00970994 -0.64549411],-0.6154980713886856
532,OASA.JK,967,241,0.5850622406639004,262,705,[ 0.11474011  0.00359297  0.10009014 -0.00687523 -0.97327791],-0.9846446217998056
533,OBMD.JK,252,62,0.5645161290322581,95,157,[ 0.23339994  0.47513629 -0.08520782 -0.09523032 -0.13671796],-0.5399353065315299
534,OILS.JK,304,76,0.631578947368421,99,205,[-0.15628843 -0.15799266 -0.08007764 -0.01186527 -0.32723737],-0.74249535334286
535,OKAS.JK,967,241,0.6514522821576764,318,649,[-0.17799224  0.0473208  -0.03566477 -0.00498526 -0.22912784],-0.7253193824998303
536,OLIV.JK,170,42,0.8095238095238095,40,130,[-0.10810878  0.13565346 -0.19144184 -0.05505414  0.56975811],-1.2318267382923564
537,OMED.JK,72,18,0.6666666666666666,27,45,[-0.01781188  0.41535544  0.45524462  0.11781149  0.08671227],-0.48002786223672933
538,OPMS.JK,684,171,0.7426900584795322,256,428,[ 0.05660527  0.10379012  0.10366051 -0.01086781  0.38265408],-0.5289645256829912
539,PACK.JK,20,5,0.6,10,10,[-0.02595946 -0.1313916  -0.19315255 -0.11475866 -0.04750678],0.08982585795720197
540,PADA.JK,55,13,0.5384615384615384,18,37,[-0.03352115 -0.48357966  0.05288723 -0.1979013   0.20587026],-0.7313697359659996
541,PADI.JK,966,241,1.0,130,836,[-0.13111418  0.05840471 -0.1339339  -0.01366989 -0.09154067],-1.8703726408044206
542,PALM.JK,968,241,0.6390041493775933,348,620,"[-3.09101837e-01 -7.73140441e-03 -4.08364229e-03 -6.76634849e-04
 -1.45509852e+00]",-0.5748703364738306
543,PAMG.JK,729,182,0.7307692307692307,248,481,[ 0.20953911 -0.00128336  0.02837614  0.0150288  -0.75326   ],-0.6589293027475333
544,PANI.JK,895,223,0.6053811659192825,318,577,"[ 3.64061181e-01 -7.57433871e-03 -7.69963320e-03  8.23929702e-04
 -1.64344379e+00]",-0.5972998537488236
545,PANR.JK,967,241,0.5684647302904564,357,610,[ 0.03409176  0.02287805  0.13161343  0.00054713 -0.23276835],-0.5396357558434859
546,PANS.JK,967,241,0.5518672199170125,370,597,"[-1.17937149e-04  3.08446490e-02 -1.19623255e-01 -3.32577029e-04
 -1.22587598e+00]",-0.47932295731732155
547,PBID.JK,967,241,0.6058091286307054,385,582,[-0.05828458 -0.02233447 -0.02347935 -0.03633505 -2.15411884],-0.40872430817146405
548,PBRX.JK,967,241,0.7012448132780082,316,651,[ 0.00412721 -0.00899935  0.04428487 -0.00387214 -0.07839403],-0.7194429214890586
549,PBSA.JK,968,241,0.6099585062240664,259,709,[-0.17480982 -0.04466715 -0.0673781  -0.02712246 -0.04932552],-1.0090350749850603
550,PCAR.JK,967,241,0.7800829875518672,275,692,[ 0.02349021  0.01812677  0.04438076 -0.01696015 -0.03470576],-0.914496620966861
551,PDES.JK,968,241,0.7676348547717843,191,777,[-0.01609969 -0.07720416 -0.01586436 -0.04706627  0.11754686],-1.4279564807715308
552,PDPP.JK,72,17,0.4117647058823529,30,42,[-0.07172616 -0.22153488  0.04526678  0.02577085 -0.05270385],-0.39645025557378094
553,PEGE.JK,967,241,0.6514522821576764,292,675,[ 0.26718586 -0.00351423 -0.0321311   0.05145084 -0.90953386],-0.8300327995537667
554,PEHA.JK,838,209,0.7081339712918661,298,540,[-0.16791345  0.02394764  0.0064613  -0.00511511 -1.12304567],-0.596393911173199
555,PEVE.JK,29,7,0.5714285714285714,11,18,[-0.04128017  0.96510807  0.1490866   0.05863193 -0.33406368],-0.3923896102003156
556,PGAS.JK,967,241,0.5560165975103735,423,544,[-0.16477412 -0.01076621  0.037789   -0.00550515 -0.34060913],-0.2500036015319573
557,PGEO.JK,11,2,0.0,5,6,[-0.0055523   0.11393352  0.089561   -0.06909309 -0.18097052],-0.36502903691460536
558,PGJO.JK,620,154,0.7012987012987013,210,410,[ 0.33590388  0.2421643   0.02176334 -0.00187736 -0.36013082],-0.6769012924511981
559,PGLI.JK,967,241,0.6431535269709544,275,692,[-0.47105815 -0.00438312 -0.02946157  0.00296698 -1.56846356],-0.9196040217450682
560,PGUN.JK,529,132,0.6363636363636364,170,359,[-0.28901457 -0.06782122  0.00255157  0.03229339 -1.06714595],-0.7401236838568426
561,PICO.JK,967,241,0.6265560165975104,317,650,[ 0.0471703  -0.02306114 -0.02433904 -0.01037271 -1.83844928],-0.719396659461484
562,PJAA.JK,967,241,0.6680497925311203,284,683,[-0.14165824 -0.03015197  0.00464394  0.00766867 -0.04197996],-0.8748006275908657
563,PKPK.JK,967,241,0.5352697095435685,248,719,[-0.18685492 -0.02047824 -0.01278209  0.00911699 -0.84899163],-1.072699420420526
564,PLAN.JK,492,123,0.7967479674796748,138,354,[ 0.13083374  0.04093344 -0.00321654 -0.0064728  -0.63839264],-0.9499470506067023
565,PLIN.JK,968,241,0.6639004149377593,135,833,"[-5.06349551e-01  2.24620246e-04  1.80147565e-01  1.14804104e-02
  2.22156742e-01]",-1.8435091462390294
566,PMJS.JK,635,158,0.6265822784810127,222,413,"[-2.33958291e-01  1.60770539e-02 -1.66681057e-03  5.51799691e-03
 -1.95774140e+00]",-0.6224634025345146
567,PMMP.JK,441,110,0.7181818181818181,184,257,[-0.14381237 -0.01588009 -0.08837204  0.00226797 -1.06531895],-0.33709279009164583
568,PNBN.JK,967,241,0.5643153526970954,368,599,[-0.11289216 -0.01384506  0.01229418  0.0057985  -0.10369374],-0.48770427411346373
569,PNBS.JK,967,241,0.6556016597510373,213,754,[-0.00887228  0.01724433 -0.04888749  0.0062861  -0.1341235 ],-1.2842977741875798
570,PNGO.JK,501,125,0.664,166,335,"[-2.00012271e-01 -1.19880578e-02 -2.63829059e-04 -1.15625329e-02
 -1.87148449e+00]",-0.7009474586673652
571,PNIN.JK,967,241,0.5850622406639004,355,612,[-0.14800131  0.03838876 -0.02092714 -0.00705181 -2.04348165],-0.5401134006221097
572,PNLF.JK,968,241,0.5850622406639004,352,616,[-0.10702717  0.00465142  0.02476218 -0.00661112 -0.28206996],-0.5566428448936742
573,PNSE.JK,966,241,0.8630705394190872,150,816,[ 0.19767532  0.03170479  0.04982554  0.02329645 -0.02004199],-1.6961572143620265
574,POLA.JK,860,215,0.7162790697674418,236,624,[ 0.21356911  0.00490212 -0.0026593  -0.00586213 -1.14369888],-0.9707455370040986
575,POLI.JK,829,207,0.6666666666666666,310,519,[-0.06429433  0.12532564 -0.0746     -0.00967728 -1.90636515],-0.5241440106090501
576,POLL.JK,934,233,0.721030042918455,319,615,[ 0.97802745  0.01217951 -0.0133686   0.02696414  0.42026762],-0.6627722014107505
577,POLU.JK,735,183,0.639344262295082,212,523,"[-6.28108558e-01  2.73325425e-04 -1.07113918e-01 -8.25421465e-03
  7.34073422e-02]",-0.9205509584155451
578,POLY.JK,968,241,0.7427385892116183,243,725,[-0.38367442  0.0025637   0.03482949  0.00396011 -1.84264981],-1.0938369867105586
579,POOL.JK,966,241,1.0,150,816,[-0.35739929 -0.04085145  0.72417477  0.02846439  0.18819325],-1.6929563726470969
580,PORT.JK,967,241,0.6804979253112033,188,779,[-1.00789021  0.00279498 -0.003412    0.01551661 -0.15168544],-1.4232724978091187
581,POSA.JK,760,189,1.0,17,743,[-0.15821681  1.36445715  0.83559739 -0.81039348  1.10002514],-3.803847279027145
582,POWR.JK,967,241,0.6680497925311203,290,677,[-0.02204055  0.02885374  0.05906246 -0.0043838  -1.14481919],-0.8455377483534601
583,PPGL.JK,522,130,0.5846153846153846,183,339,[ 0.10129218 -0.00373231 -0.06547475  0.06953399  0.31329955],-0.6294804765412834
584,PPRE.JK,967,241,0.6639004149377593,339,628,"[ 9.94151305e-05  6.16519904e-02 -5.60539698e-02  2.35190018e-04
 -1.36998830e-02]",-0.615635344661484
585,PPRO.JK,967,241,0.9294605809128631,250,717,[-0.05225138 -0.00488668  0.08643235  0.00216233 -0.15669731],-1.046235803408551
586,PRAS.JK,967,241,0.7178423236514523,271,696,[-0.26667491  0.00260979  0.02079832  0.00489543 -1.41759151],-0.9416813140751984
587,PRAY.JK,72,18,0.7777777777777778,27,45,[ 0.01206533 -0.00603988 -0.06835357 -0.11498256 -0.2871387 ],-0.5478814697389062
588,PRDA.JK,967,241,0.6099585062240664,352,615,[ 0.02901957 -0.00341523  0.0251842   0.00644716 -1.30389048],-0.5562062249717158
589,PRIM.JK,965,241,0.7219917012448133,302,663,[-0.12711005  0.00291248 -0.00321228 -0.00502223 -0.62213015],-0.7826723789278629
590,PSAB.JK,967,241,0.6058091286307054,350,617,[-0.17026081  0.10734611 -0.00167961 -0.00640914 -0.3880207 ],-0.5741363532933786
591,PSDN.JK,968,241,0.6514522821576764,311,657,[-0.56313144 -0.00254454 -0.04662668 -0.00821301 -1.05758758],-0.746711430418371
592,PSGO.JK,648,162,0.6296296296296297,250,398,[-0.20609314  0.01352713 -0.02985914 -0.0075982  -0.74770743],-0.4733612235796924
593,PSSI.JK,967,241,0.6141078838174274,399,568,[-0.17392949  0.03496523 -0.01686329  0.01454869 -0.58946335],-0.33773800753074373
594,PTBA.JK,967,241,0.5518672199170125,424,543,[ 0.02590538 -0.03705977 -0.16719964  0.01271502 -0.5319904 ],-0.24569638988811626
595,PTDU.JK,447,111,0.8378378378378378,139,308,[ 0.82684026  0.04512329 -0.00781414  0.00767355  0.50427414],-0.7971769146192581
596,PTIS.JK,968,241,0.6390041493775933,209,759,[-0.32139473 -0.01209321  0.06079192  0.00490249 -1.01332093],-1.2869991585413467
597,PTMP.JK,6,1,1.0,2,4,[-0.01204557 -0.18262244 -0.04465459 -0.4397565  -0.09823066],-1.497971486341164
598,PTPP.JK,967,241,0.6058091286307054,384,583,[ 0.11366252 -0.07270527  0.07949279  0.01159855  0.33689004],-0.42099884838898366
599,PTPW.JK,608,152,0.6513157894736842,227,381,[ 0.23691564  0.01333188 -0.22243914  0.01884361  0.66833037],-0.5360784165494729
600,PTRO.JK,967,241,0.5228215767634855,417,550,[-0.13144591 -0.00087862 -0.03777947 -0.01016773 -0.37243023],-0.2719343780566404
601,PTSN.JK,968,241,0.6514522821576764,341,627,[-0.0452264  -0.03003435 -0.00434545 -0.00756375 -0.90643749],-0.6065323421931872
602,PUDP.JK,968,241,0.6473029045643154,205,763,"[-3.08234913e-01 -4.17857361e-03  1.53606491e-02 -1.20290623e-03
 -1.34949733e+00]",-1.3130169794344906
603,PURA.JK,614,153,1.0,164,450,[ 0.00870911  0.00481784 -0.00939111 -0.00829693  0.38696739],-1.0129998628811276
604,PURE.JK,674,168,1.0,191,483,[-0.3564144  -0.03240998 -0.05660302  0.00863381 -0.73376888],-0.9359919242694763
605,PURI.JK,496,124,0.6532258064516129,165,331,"[-5.20029744e-01  2.44937885e-02  2.61514592e-01  1.58145511e-03
 -1.72010768e+00]",-0.7071616213092113
606,PWON.JK,967,241,0.6016597510373444,383,584,[-0.18296481 -0.04167095  0.05465001  0.01418436 -0.14860803],-0.42755884478703793
607,PYFA.JK,967,241,0.6721991701244814,287,680,"[-5.61211351e-03  2.69608403e-04 -7.66670973e-04 -4.59321750e-03
 -1.54429407e+00]",-0.8598361233099279
608,PZZA.JK,962,240,0.7541666666666667,347,615,[-0.08495736 -0.04996344 -0.01982439  0.00220267 -0.65112952],-0.5663883841900023
609,RAFI.JK,125,31,0.7096774193548387,44,81,[-0.05476368 -0.0135701  -0.43251537 -0.05881439 -0.34267675],-0.613595967860269
610,RAJA.JK,967,241,0.5394190871369294,332,635,[-0.01061119  0.01095526  0.03800988  0.00137608 -0.23107848],-0.6453972275258496
611,RALS.JK,968,241,0.6639004149377593,372,596,[ 0.00010561 -0.00722767  0.00511645  0.0038122   0.0801904 ],-0.47003850086188764
612,RANC.JK,967,241,0.6721991701244814,304,663,[ 0.07873536 -0.06572188  0.07017101 -0.01503892 -0.3317279 ],-0.7792475549173127
613,RBMS.JK,967,241,0.8713692946058091,214,753,[-0.32753708  0.01830761 -0.0312791  -0.00540398 -0.52362968],-1.2691927015717384
614,RCCC.JK,128,31,0.3870967741935484,49,79,"[-2.17684639e-02  7.42980365e-05 -4.17992919e-02  6.06605709e-03
 -9.29792899e-02]",-0.45641094657503545
615,RDTX.JK,968,241,0.7219917012448133,169,799,[-0.13584829 -0.00873055 -0.02785789  0.00417653 -0.75054363],-1.5552010143210369
616,REAL.JK,641,160,1.0,93,548,[-0.17145322 -0.11353354  0.7884184  -0.00370877 -0.25618735],-1.8003886759238175
617,RELI.JK,967,241,0.7219917012448133,186,781,[-0.6380044   0.02544392 -0.02248009 -0.003442   -0.52605826],-1.4358420636195837
618,RICY.JK,967,241,0.6473029045643154,313,654,"[-3.63830591e-01 -1.90740541e-02 -1.36375111e-01  7.77633149e-04
 -2.35687539e+00]",-0.7381074057274557
619,RIGS.JK,967,241,0.6348547717842323,352,615,[-0.04419336 -0.00648979 -0.05360121 -0.01663012 -1.06742712],-0.5568634680568464
620,RIMO.JK,966,241,1.0,130,836,[-0.0403748   0.00329562  0.12575028 -0.0205971  -0.80753354],-1.873566958223523
621,RISE.JK,936,233,0.703862660944206,315,621,[ 0.2205202   0.06560606 -0.02737276  0.00284435  0.75944542],-0.6829929303412761
622,RMBA.JK,952,238,1.0,240,712,[ 0.03716179  0.0230552   0.02383757 -0.00424803 -2.04826616],-1.0905947140229915
623,RMKE.JK,252,63,0.6031746031746031,108,144,[-0.17270236  0.57935672 -0.07408448 -0.04389285  0.47640302],-0.3143430107242528
624,ROCK.JK,495,123,0.7235772357723578,157,338,[-0.59521314 -0.10525971 -0.01598772 -0.00263557 -1.6616865 ],-0.7597888432733086
625,RODA.JK,967,241,0.7468879668049793,274,693,[-0.20867762 -0.03569719 -0.01231302 -0.0144812  -1.81154574],-0.9346861392275867
626,RONY.JK,573,143,1.0,128,445,[-0.03637407 -0.00961157  0.38286281 -0.02761515 -0.86224752],-1.2619832764518075
627,ROTI.JK,967,241,0.6431535269709544,290,677,[ 0.01038449  0.13596769  0.00780753 -0.00395006 -0.02427826],-0.846965811789972
628,RSGK.JK,303,75,0.64,109,194,[-0.04922489  0.09284409 -0.29541997  0.02400922 -0.72987819],-0.5692458116663617
629,RUIS.JK,968,241,0.6265560165975104,288,680,[-0.25119647 -0.05029206 -0.06271757  0.03966665 -1.29892375],-0.856769379197311
630,RUNS.JK,303,75,0.5733333333333334,110,193,[ 0.04685862 -0.04354645 -0.21678763 -0.00941548 -0.61753139],-0.5545481807859008
631,SAFE.JK,968,241,0.7136929460580913,304,664,"[-8.33223054e-01  1.63090952e-02 -3.03238232e-02  6.30432450e-04
 -1.69013433e+00]",-0.7765813268849217
632,SAME.JK,967,241,0.6182572614107884,341,626,[-0.00475607  0.03199785 -0.02155118  0.00296962 -0.4001376 ],-0.6092900254494495
633,SAMF.JK,580,144,0.5,196,384,[ 0.35110311  0.00882273 -0.02805595 -0.02824467  0.77880296],-0.6757593494628256
634,SAPX.JK,887,221,0.669683257918552,206,681,[-0.5566722  -0.02144682 -0.09884104  0.00845479 -0.00474388],-1.189519400914083
635,SATU.JK,868,216,0.7777777777777778,213,655,"[-1.60103430e-01  2.33332637e-02  1.06800709e-03 -5.71865359e-02
 -1.21752730e+00]",-1.136992613441612
636,SBAT.JK,574,143,1.0,81,493,[ 0.51031399  1.08230653  0.42931475 -0.03273934  0.87467479],-1.7797413141044836
637,SBMA.JK,303,75,0.6,107,196,"[ 3.90567014e-01  2.85737761e-04  2.05327809e-02 -3.50531576e-02
  6.78874208e-01]",-0.6064544398394367
638,SCCO.JK,967,241,0.6887966804979253,238,729,[-0.18938236  0.00208499 -0.0137021   0.02336377 -1.41771342],-1.112523636658238
639,SCMA.JK,968,241,0.6348547717842323,389,579,[-0.06117491 -0.02133989  0.09356942  0.00465509 -1.05651032],-0.3966442766839623
640,SCNP.JK,497,124,0.717741935483871,157,340,"[-1.25331463e-01 -1.49883296e-02 -1.67246530e-01  3.08435225e-04
 -3.72946711e-01]",-0.7768787238858922
641,SDMU.JK,967,241,0.5394190871369294,136,831,"[ 1.34170092e-17 -1.04458168e-07 -1.42059353e-08  1.77564240e-07
 -9.22918456e-17]",-2.3749783076720072e-14
642,SDPC.JK,967,241,0.6265560165975104,329,638,[-0.51852937  0.0052083  -0.0265068   0.00345259 -0.70287686],-0.6656710269691841
643,SDRA.JK,967,241,0.6680497925311203,227,740,[-0.78501889 -0.01055896  0.0126768  -0.00450679 -0.55999631],-1.1787179583820282
644,SEMA.JK,234,58,0.7586206896551724,83,151,[ 0.04148967 -0.03221218  0.09090353  0.04337944 -0.30497405],-0.6241663031414529
645,SFAN.JK,738,184,0.625,247,491,[ 0.09226567  0.00076191 -0.10482686 -0.02858002 -0.00100671],-0.6843871270060934
646,SGER.JK,511,127,0.7007874015748031,233,278,"[1.79955708e-01 6.02844099e-02 7.40389790e-02 1.23904397e-04
 1.34952119e-01]",-0.18033053042215555
647,SGRO.JK,967,241,0.6597510373443983,316,651,"[-6.86239514e-02 -2.96616980e-02 -1.25499110e-03  1.02355648e-02
 -1.74703437e+00]",-0.7282958297117679
648,SHID.JK,968,241,0.6597510373443983,209,759,[ 0.4061031   0.00785751  0.03693089 -0.0042798   0.08004983],-1.2915407115570943
649,SHIP.JK,967,241,0.5352697095435685,352,615,[-0.34735755 -0.00656308 -0.01003046  0.02714066 -0.17536432],-0.5553097245555724
650,SICO.JK,185,46,0.7608695652173914,66,119,[-0.02112162  0.03532154 -0.02262498  0.02233598 -0.41695814],-0.5831701315839526
651,SIDO.JK,968,241,0.6058091286307054,372,596,[-0.06359054  0.01786047 -0.01163549 -0.03586472 -0.17996491],-0.4679444679507224
652,SILO.JK,968,241,0.5601659751037344,412,556,[ 0.10359071 -0.03518831 -0.00234745 -0.00927528  0.06437477],-0.30114414804592515
653,SIMA.JK,966,241,1.0,117,849,[0.21624676 0.03808871 0.70524135 0.01221591 0.29163023],-1.9827174867305997
654,SIMP.JK,967,241,0.6846473029045643,366,601,[-0.00314855  0.05334207  0.0050334  -0.00730275 -0.15877374],-0.5023855667158356
655,SINI.JK,657,164,0.5792682926829268,242,415,[-0.38187041  0.00483257  0.00495861 -0.01631253 -1.79010671],-0.540192493650003
656,SIPD.JK,968,241,0.7219917012448133,253,715,[-0.51919796  0.01303331 -0.00096332 -0.00133477 -0.79364327],-1.0344883066886923
657,SKBM.JK,967,241,0.6016597510373444,258,709,[-1.02535233 -0.00448746 -0.02075763  0.00361716 -1.45855912],-1.00929345740376
658,SKLT.JK,968,241,0.7593360995850622,168,800,[-0.55078816  0.08514153 -0.04722123  0.05325383 -1.28553123],-1.5693136673431078
659,SKRN.JK,882,220,0.5727272727272728,353,529,"[-5.86333165e-02  7.52606719e-04  8.66720594e-02  1.57831740e-03
 -9.53726300e-01]",-0.40493385653404734
660,SKYB.JK,966,241,1.0,104,862,[-0.22301794 -0.15419619  0.02852651  0.02964493 -0.1299948 ],-2.1272799363141357
661,SLIS.JK,676,169,0.6804733727810651,274,402,[ 0.80732375 -0.01163205  0.05917187  0.0392714   1.44841035],-0.3940085661562415
662,SMAR.JK,968,241,0.5892116182572614,280,688,[-0.16314917 -0.02093822  0.08745027  0.00431643 -0.09753472],-0.8969252760048785
663,SMBR.JK,967,241,0.6390041493775933,331,636,[ 0.1481654  -0.14140705 -0.07297168  0.0010526  -0.4010112 ],-0.6442715243492612
664,SMCB.JK,968,241,0.6846473029045643,318,650,[ 0.17969596 -0.00427601 -0.00391116  0.0039277  -0.04739249],-0.7203167048494954
665,SMDM.JK,967,241,0.6431535269709544,334,633,[-0.66568324  0.00598374  0.02763089 -0.00799402 -2.87450377],-0.6451351692142819
666,SMDR.JK,968,241,0.6390041493775933,383,585,[-0.01351071  0.00063626  0.01017876 -0.00054179 -0.31172263],-0.4212257299800951
667,SMGR.JK,967,241,0.5892116182572614,424,543,[-0.00986938 -0.00109787 -0.00152081 -0.0091214  -0.56796792],-0.24320897751094447
668,SMKL.JK,726,181,0.5580110497237569,269,457,[-0.20425887  0.01018526  0.10376652  0.01124353 -1.65884272],-0.5284089092126962
669,SMKM.JK,203,50,0.48,101,102,[ 0.22336241  0.30422025  0.3252026  -0.08439416  0.24002446],0.00813770649818174
670,SMMA.JK,968,241,0.9128630705394191,150,818,[-0.15396513  0.05385462  0.00361671 -0.01758179 -0.7301969 ],-1.6948106537510743
671,SMMT.JK,967,241,0.6390041493775933,362,605,"[-5.29012917e-02 -8.14579246e-03 -5.44499023e-02 -8.04095064e-04
 -1.46525336e+00]",-0.5071785371645429
672,SMRA.JK,967,241,0.6182572614107884,384,583,[-0.00978235  0.0245503   0.0025056   0.01276847  0.02804344],-0.4195645724963553
673,SMRU.JK,966,241,1.0,92,874,[-0.31210605  0.14164314  0.37642987 -0.0555702   0.87226197],-2.2768300080467467
674,SMSM.JK,968,241,0.5643153526970954,424,544,[-0.13926312 -0.06978606  0.00821996 -0.00563176 -0.2181296 ],-0.24440800128305074
675,SNLK.JK,389,97,0.5154639175257731,183,206,[ 0.5577131   0.07128447 -0.1729171  -0.03242791  1.50734011],-0.10497854137604425
676,SOCI.JK,967,241,0.6016597510373444,354,613,[-0.28602658 -0.03341479  0.03256166 -0.00263233 -1.09416098],-0.5459103434180985
677,SOFA.JK,529,132,0.8712121212121212,153,376,"[ 5.89395091e-01  1.34692593e-01  3.71440233e-01  1.99992368e-04
 -1.17001012e+00]",-0.892950501680092
678,SOHO.JK,496,124,0.8064516129032258,165,331,"[-1.99567583e-01 -6.28592765e-02  1.61921787e-01  3.45204916e-04
 -1.21585246e+00]",-0.6915975364959442
679,SONA.JK,968,241,0.983402489626556,73,895,[ 0.46000508 -0.00387903 -0.00408308 -0.00135104 -0.08567422],-2.499770765030304
680,SOSS.JK,867,216,0.5416666666666666,339,528,"[-4.65516387e-01  1.00833461e-03 -4.07870606e-02 -2.48835114e-03
 -1.59996887e+00]",-0.44229654893522696
681,SOTS.JK,847,211,0.6919431279620853,276,571,"[-4.77454204e-01  2.82923412e-02 -2.63358365e-02  9.74020334e-04
 -2.07796160e+00]",-0.7249784966165086
682,SOUL.JK,38,9,0.7777777777777778,9,29,[-0.00316485  0.07354626  0.09359658  0.42218861  0.42847197],-1.1714065001553555
683,SPMA.JK,968,241,0.6182572614107884,370,598,[-0.35944864 -0.02208245  0.11053777 -0.0058091  -1.45865832],-0.47777987646629577
684,SPTO.JK,967,241,0.7302904564315352,320,647,[-0.01604116 -0.06058206 -0.02450729 -0.00489096 -0.87817668],-0.6941258457481317
685,SQMI.JK,967,241,0.6970954356846473,296,671,"[ 4.56129676e-01  4.18596822e-04  6.84504511e-02  2.15954863e-03
 -6.80768544e-02]",-0.817265610417854
686,SRAJ.JK,968,241,0.6265560165975104,334,634,"[-8.05746396e-01 -1.21876750e-02 -4.10636404e-03 -1.04575990e-03
 -1.38470287e+00]",-0.6386019486845005
687,SRIL.JK,966,241,1.0,256,710,[-0.20253357 -0.01028877  0.0527543  -0.0054703  -0.56146973],-1.0224860128200144
688,SRSN.JK,967,241,0.8174273858921162,277,690,"[-1.39610747e-01  3.50502909e-03  1.09368898e-01  3.93470207e-05
 -2.17976056e+00]",-0.9207340132093191
689,SRTG.JK,968,241,0.6058091286307054,377,591,"[-7.53257140e-02 -3.85625559e-04 -6.98974688e-03 -3.76201391e-03
 -1.61459602e+00]",-0.44827944166340583
690,SSIA.JK,967,241,0.5726141078838174,351,616,[-0.03819712  0.0063118   0.02819812 -0.00102673 -0.80589335],-0.5599210779158147
691,SSMS.JK,967,241,0.5145228215767634,368,599,[-0.03093611  0.01012178  0.1121736  -0.00198082 -1.33932143],-0.4825232054057965
692,SSTM.JK,968,241,0.7759336099585062,260,708,[-0.85424596 -0.07743245 -0.02674209  0.01415458  0.08368273],-1.013530822352199
693,STAA.JK,202,50,0.64,85,117,[-0.01247302  0.31280304 -0.78455986 -0.03006165 -1.00573427],-0.3381963484210727
694,STAR.JK,967,241,0.7302904564315352,295,672,[-0.05985207 -0.0218889   0.00965646  0.00328704 -2.45847345],-0.830093525843016
695,SULI.JK,967,241,0.5850622406639004,114,853,[0. 0. 0. 0. 0.],0.0
696,SUNI.JK,37,9,0.6666666666666666,15,22,[-0.00807012  0.36271122  0.5404431  -0.23645461  0.3995    ],-0.5515016306104706
697,SURE.JK,884,220,0.9409090909090909,168,716,[-0.31346396 -0.03166145 -0.00135956 -0.00136091 -1.23196364],-1.4469487054883474
698,SWAT.JK,946,236,0.7966101694915254,313,633,[-0.53274774  0.04584345  0.01540049  0.0108908  -0.7592153 ],-0.7056398858166041
699,SWID.JK,142,35,0.6857142857142857,38,104,[-0.04767801  0.05436726  0.19414282  0.07738393 -0.90653624],-1.0061396981148103
700,TALF.JK,966,241,0.7012448132780082,251,715,[-0.89281572  0.03533627 -0.10248414 -0.00436865 -1.42873295],-1.0477498533066882
701,TAMA.JK,608,151,1.0,166,442,[-0.15670578  0.04895637 -0.04032726  0.01059277 -0.39631326],-0.9920608135975101
702,TAMU.JK,968,241,1.0,255,713,[-0.10021691  0.10532324  0.0148734   0.01620501  0.41855194],-1.030493844052599
703,TAPG.JK,382,95,0.6736842105263158,157,225,[-0.1904973  -0.17361516 -0.01102559  0.00647311 -0.39501017],-0.3671866371171322
704,TARA.JK,966,241,0.0,159,807,"[ 1.14595165e-17  3.47897801e-08  4.73120237e-09 -5.91345330e-08
 -1.65045642e-13]",-3.801636365695787e-15
705,TAYS.JK,253,63,0.7619047619047619,92,161,[-0.06182177  0.01613606  0.20337859 -0.0138366   0.34300149],-0.5732586326722974
706,TBIG.JK,968,241,0.5767634854771784,424,544,[-0.02552747  0.00469319  0.06865436  0.01273097 -0.71410254],-0.24678711793502478
707,TBLA.JK,967,241,0.7053941908713693,386,581,[-0.09216415  0.01569066  0.14218264  0.00564042 -0.04161062],-0.40843672545501997
708,TBMS.JK,967,241,0.7136929460580913,252,715,"[-3.34120558e-01  7.32631790e-04 -2.80065556e-02  6.32265092e-03
 -1.25642747e+00]",-1.0446579244827114
709,TCID.JK,967,241,0.6224066390041494,190,777,[-0.19564086 -0.01153176  0.05674396 -0.0048945  -0.54242657],-1.407164929353392
710,TCPI.JK,936,234,0.5299145299145299,414,522,[ 0.12167051  0.10480335  0.04089506  0.02836608 -0.04164785],-0.23719719413314463
711,TDPM.JK,966,241,1.0,245,721,[-0.3404385   0.01227531 -0.00378074  0.00502109 -0.08100638],-1.0759892919995664
712,TEBE.JK,652,163,0.588957055214724,185,467,[-0.13493933  0.01111668  0.03719138 -0.00086653 -0.23995374],-0.9208955153753362
713,TECH.JK,548,136,0.7720588235294118,212,336,[ 0.53245807 -0.02141559  0.00476689 -0.04952703  1.37186051],-0.48264091169906437
714,TELE.JK,790,197,0.9949238578680203,150,640,[-0.32722654 -0.00565332 -0.03460946  0.03271774 -0.15605553],-1.4586456143132582
715,TFAS.JK,688,171,0.5847953216374269,245,443,[ 0.57634726  0.11265685 -0.00436272  0.05785381  0.0393246 ],-0.5903913427822036
716,TFCO.JK,966,241,0.9004149377593361,229,737,[-0.09876231  0.01065819 -0.0486623  -0.00093561 -0.1630178 ],-1.1680308867962734
717,TGKA.JK,968,241,0.7012448132780082,213,755,[-0.20240149  0.07765969  0.00635224 -0.02406286 -0.75581225],-1.2889374267195308
718,TGRA.JK,967,241,0.8464730290456431,307,660,[ 0.09174759 -0.00355804 -0.0098858  -0.00069209 -0.32525083],-0.7610566644246477
719,TIFA.JK,967,241,0.7302904564315352,323,644,[ 0.27953043  0.00155285  0.00342108 -0.0369908  -0.63492258],-0.6884273682924538
720,TINS.JK,967,241,0.6099585062240664,393,574,[-0.11563224 -0.09536821 -0.04452308  0.0043649  -0.55304408],-0.3796074684063534
721,TIRA.JK,967,241,0.6473029045643154,302,665,[-0.67589442 -0.00368072  0.02778161 -0.04563441 -1.75060077],-0.7936710360762436
722,TIRT.JK,967,241,0.8298755186721992,252,715,[-0.54365913  0.01396466 -0.03855195 -0.0045422  -3.08977258],-1.0611162350418886
723,TKIM.JK,967,241,0.6058091286307054,397,570,[-0.16855612  0.03136889 -0.00990901  0.05346975  0.46780511],-0.36666940055440334
724,TLDN.JK,184,45,0.6666666666666666,39,145,[-0.03629252 -0.15098535 -0.28219471  0.00630485 -0.90322405],-1.3073335124933456
725,TLKM.JK,967,241,0.5477178423236515,416,551,[-0.18151003  0.01570295 -0.01653276 -0.00136898 -0.60342017],-0.2867613028466363
726,TMAS.JK,968,241,0.5269709543568465,316,652,[ 0.08212242  0.07128691  0.0050246  -0.00852151 -0.76903703],-0.7143821841164728
727,TMPO.JK,967,241,0.6763485477178424,295,672,"[-7.17669153e-01  1.16005367e-02  5.79956032e-03 -2.23955633e-04
 -2.19619439e+00]",-0.8201563686018202
728,TNCA.JK,941,235,0.6680851063829787,341,600,"[-3.85753742e-02 -1.90344872e-04  1.14943169e-01  3.94355559e-04
 -7.53828316e-01]",-0.5610378558490584
729,TOBA.JK,967,241,0.6556016597510373,258,709,"[ 5.30270489e-02  6.98739800e-03  1.14333708e-01 -7.35248054e-04
 -7.96133905e-01]",-1.0075654514680195
730,TOOL.JK,124,30,0.7,26,98,"[-2.53682514e-02 -7.56044187e-02  5.18941268e-01  1.39658334e-03
  1.66804620e+00]",-1.3358200912126919
731,TOPS.JK,967,241,1.0,141,826,[0. 0. 0. 0. 0.],0.0
732,TOTL.JK,967,241,0.6265560165975104,309,658,[-0.07884198  0.00375536 -0.0514817  -0.02036082 -0.29691122],-0.759148308264956
733,TOTO.JK,967,241,0.6846473029045643,302,665,"[-1.04746013e-01 -8.30037767e-03 -1.29522862e-04  2.45049352e-02
 -2.51086026e+00]",-0.7959691331382062
734,TOWR.JK,967,241,0.5933609958506224,368,599,[-0.12541326 -0.01149634 -0.01041668  0.0196568  -1.14026331],-0.4832156277190758
735,TOYS.JK,512,128,0.7265625,164,348,[ 0.1161826  -0.12205609  0.44325992 -0.04643732 -0.54891845],-0.7705297161142363
736,TPIA.JK,968,241,0.5933609958506224,462,506,[ 0.65507475 -0.03068388 -0.331464   -0.01357356  0.54437948],-0.10904514940372824
737,TPMA.JK,967,241,0.5767634854771784,278,689,[ 0.00920926 -0.08212672  0.03008589 -0.00103905 -0.24616486],-0.9037118076391567
738,TRAM.JK,966,241,1.0,125,841,[-0.68640878  0.04605805 -0.07394609  0.0898618  -0.48413927],-1.921923925943942
739,TRGU.JK,141,35,0.7142857142857143,37,104,[-0.04947201  0.04393369  0.6907062   0.01277399 -0.76847465],-1.0087560837988052
740,TRIM.JK,967,241,0.6224066390041494,305,662,[-0.30827446 -0.00771276 -0.1015038   0.03228862 -2.973569  ],-0.7934140070390124
741,TRIN.JK,622,155,0.6516129032258065,237,385,[ 0.09540865  0.06365152  0.09169023 -0.01104516 -0.02761431],-0.47693986592446636
742,TRIS.JK,968,241,0.6182572614107884,300,668,[-0.60682523 -0.02299941  0.0262617   0.00870288 -0.9175655 ],-0.7956992161205143
743,TRJA.JK,503,125,0.6,210,293,[ 0.00249928  0.08083844 -0.11821652  0.01198469  0.34273496],-0.34023957918518216
744,TRON.JK,4,1,1.0,2,2,[-0.00133418  0.08798361  0.45320118 -0.00567692  0.08787555],-0.21853261365097645
745,TRST.JK,967,241,0.7385892116182573,159,808,"[-5.73032691e-02  1.27823626e-01  1.38188704e-02  2.03379176e-04
 -1.89135261e+00]",-1.645755806990748
746,TRUE.JK,352,87,0.9770114942528736,88,264,[-0.0129895   0.13536848 -0.44828072  0.08243753 -0.29315006],-1.119820556728044
747,TRUK.JK,961,240,0.65,326,635,[-0.24336369 -0.01114568 -0.04092994  0.01040494 -0.22270568],-0.6638226634172198
748,TRUS.JK,968,241,0.6141078838174274,274,694,[-0.91932302 -0.00101236  0.0230827  -0.00264054 -0.60607328],-0.9246070100472847
749,TSPC.JK,968,241,0.6680497925311203,343,625,[ 0.00602081  0.01038716 -0.02034132 -0.00331298 -0.25893995],-0.5997161936026864
750,TUGU.JK,960,239,0.5857740585774058,293,667,[-0.29430687  0.0443247   0.03185558  0.00701424  0.09951459],-0.8255317257105779
751,UANG.JK,530,132,0.6363636363636364,168,362,[-0.12638318 -0.02222427  0.00194878 -0.09195259 -0.78647427],-0.7712445094551478
752,UCID.JK,633,158,0.6708860759493671,224,409,[-0.00435298  0.00166341 -0.08548663 -0.0095318  -0.16653728],-0.6018927754338247
753,UFOE.JK,420,104,0.5673076923076923,173,247,[ 0.42203487 -0.02802559 -0.025283    0.0082752   1.95256781],-0.36721330529686735
754,ULTJ.JK,967,241,0.6099585062240664,349,618,[-0.13760756  0.01163284  0.10305007 -0.00437444 -0.73589993],-0.5672759541862487
755,UNIC.JK,967,241,0.6680497925311203,314,653,[-0.03138993  0.0151791  -0.02612299  0.00134153 -0.86707   ],-0.7266568596258839
756,UNIQ.JK,400,100,0.69,102,298,[-0.18650612 -0.02438566  0.27912447  0.00346272 -2.69791107],-1.0902515243135633
757,UNIT.JK,967,241,1.0,212,755,"[-4.75199896e-01 -5.47138267e-03  1.01545497e-03  1.41475639e-02
 -1.45125950e+00]",-1.2752721538359972
758,UNSP.JK,967,241,0.5933609958506224,368,599,[-0.09132802  0.01595526 -0.01668242 -0.01384614 -0.84908027],-0.4811906294945341
759,UNTR.JK,967,241,0.5435684647302904,431,536,[-0.04313784 -0.03418321  0.00646462 -0.00949322 -0.92268631],-0.21069282580012919
760,UNVR.JK,968,241,0.5394190871369294,396,572,[-0.021968    0.01857208 -0.01007914 -0.00054958 -0.52343037],-0.3648746100340633
761,URBN.JK,848,211,0.5971563981042654,187,661,[ 0.16014767 -0.00045969 -0.03748837  0.00409627 -0.00921956],-1.267878213488339
762,UVCR.JK,326,81,0.654320987654321,122,204,[-0.00685979 -0.07522756 -0.40846299  0.08666025  0.81767165],-0.5513111840542825
763,VAST.JK,20,5,0.8,5,15,[-0.01231402 -0.32569353 -0.27246696 -0.08217546 -0.21272293],-1.2308264664495268
764,VICI.JK,442,110,0.5818181818181818,158,284,[ 0.12431297  0.03640397 -0.16074307  0.02297591  0.39067957],-0.5678993280637779
765,VICO.JK,967,241,0.6680497925311203,331,636,"[-4.22317071e-01  1.42252927e-03 -6.65579885e-03 -2.53042805e-03
 -3.10897307e+00]",-0.6594332786912082
766,VINS.JK,967,241,0.6307053941908713,357,610,[-0.72455316 -0.00433755  0.00932936  0.00258451 -1.74998519],-0.5288636519325346
767,VIVA.JK,967,241,1.0,171,796,[-0.13000506  0.06969374 -0.03149284 -0.02414924  0.89062088],-1.5405231869369052
768,VOKS.JK,967,241,0.5518672199170125,363,604,[-0.2721637   0.03651729  0.05170415  0.00232092 -1.00854847],-0.5078028628725795
769,VRNA.JK,968,241,0.6348547717842323,248,720,[-0.64263763  0.04118353  0.03759079 -0.00168228 -0.11725008],-1.071095380695014
770,VTNY.JK,51,12,0.6666666666666666,22,29,[-0.01033971 -0.39863858  0.29971514 -0.04235398 -0.10187243],-0.3582275157581808
771,WAPO.JK,968,241,0.6307053941908713,298,670,"[-7.94623453e-02 -4.17573380e-04 -8.61752648e-03 -2.51773033e-03
 -2.04632285e+00]",-0.8120665051701577
772,WEGE.JK,967,241,0.6556016597510373,373,594,[-0.03243855 -0.01472276 -0.00736982 -0.00602399 -1.07943104],-0.4621533272621796
773,WEHA.JK,967,241,0.6390041493775933,297,670,[0.01422741 0.02202631 0.02713621 0.0014375  0.52627307],-0.8233268118117602
774,WGSH.JK,253,63,0.6666666666666666,95,158,[-0.00265983  0.05216631  0.10143935 -0.00215534 -0.23921682],-0.5083698268887282
775,WICO.JK,966,241,0.7842323651452282,183,783,[-0.66427413  0.01893867 -0.00265864  0.02465012 -2.40377035],-1.4763336527162814
776,WIFI.JK,436,109,0.6238532110091743,153,283,[ 0.01170362 -0.06453397  0.04274526 -0.00334895  0.36240842],-0.6179554616770006
777,WIIM.JK,967,241,0.5643153526970954,329,638,[ 0.00676573 -0.0127854  -0.00241191 -0.00062298  0.15779127],-0.6637368262749376
778,WIKA.JK,967,241,0.6514522821576764,398,569,[ 0.00052723  0.02293719  0.02434909 -0.00214459 -0.33906656],-0.35252292171809174
779,WINE.JK,36,9,0.6666666666666666,15,21,[ 0.00132656 -0.0558771   0.32390273  0.32288416  0.04340543],-0.40542317917091886
780,WINR.JK,177,44,1.0,7,170,[-0.03673731  0.12959987  0.22609809  0.32020076  0.49577938],-3.1758627018307317
781,WINS.JK,967,241,0.5560165975103735,310,657,[-0.31878353 -0.00739791  0.28533614  0.01459487 -2.09858996],-0.7590467904831047
782,WIRG.JK,188,47,0.6170212765957447,58,130,[ 0.03938075  0.0830138   0.12236163  0.00255508 -0.59111421],-0.7975745447394268
783,WMPP.JK,253,63,0.8412698412698413,98,155,[ 0.13423358  0.00665885  0.07611802  0.01164206 -0.94448031],-0.4564985217150659
784,WMUU.JK,419,104,0.7884615384615384,141,278,[-0.13341076 -0.10971589  0.02076208  0.08215148 -0.85618228],-0.6832626588569152
785,WOMF.JK,967,241,0.6182572614107884,343,624,[-0.28191437  0.00142062  0.01910911 -0.01477715 -1.25647432],-0.5925234910559056
786,WOOD.JK,967,241,0.6224066390041494,352,615,[-0.1025624   0.02569335  0.01212794 -0.00375293 -0.26433252],-0.5625791400503264
787,WOWS.JK,657,164,1.0,117,540,[-0.16523005 -0.00451299 -0.00099317  0.01777219 -0.421924  ],-1.5289394320961318
788,WSBP.JK,967,241,0.991701244813278,328,639,[-0.08925265 -0.01327477  0.07824603 -0.00058891 -0.45682772],-0.6673082196577822
789,WSKT.JK,966,241,0.6887966804979253,375,591,[ 0.00256429 -0.00383281  0.00163587 -0.0002909  -0.00152404],-0.4542649592750421
790,WTON.JK,967,241,0.6390041493775933,365,602,[-0.23043591 -0.01528079 -0.0665211  -0.03449148 -0.08534209],-0.5050552515907996
791,YELO.JK,872,217,0.7096774193548387,219,653,[-0.00986773 -0.02149462 -0.01156446 -0.0138124  -0.83401281],-1.0929413905222751
792,YPAS.JK,967,241,0.6348547717842323,251,716,[-0.55255873 -0.00188908  0.05333107 -0.00390264  0.41732503],-1.0621830723911319
793,YULE.JK,967,241,0.7800829875518672,249,718,[-0.26747763  0.00303344  0.0208098  -0.00687694 -1.13623393],-1.0608193348150838
794,ZATA.JK,71,17,0.8235294117647058,16,55,[ 0.01512692  0.8781131  -0.05694697  0.12939322  0.76831447],-1.1766008820334772
795,ZINC.JK,967,241,0.8672199170124482,363,604,[ 0.17916688  0.08139519 -0.01044174 -0.00275715  0.19365946],-0.5161196992695524
796,ZONE.JK,845,211,0.5924170616113744,313,532,[0.18042222 0.09789793 0.03215467 0.03271543 0.35592685],-0.5423615614975014
797,ZYRX.JK,388,97,0.7422680412371134,139,249,[ 0.0806164   0.01069699  0.19140863 -0.02206928  0.6250521 ],-0.586600743622468
